горовэ-э нулгӣчэвун.	долго аргишили.
ичэтно̄дем».	приду посмотреть».
****	****
амариӈдула̄вэр мучӯска̄т!	давайте повернем назад!
гошаядӯ бидичо̄тын.	у гоши они находились.
и э потом омоден долболто=, долбо уже, долбочоло̄н.	и потом он придет, уже когда настанет ночь.
бокончучэлдэн.	пошел догонять.
бэе девсамдалон, гирамдамӣла девувкӣ одяӈа̄с.	будешь есть за человеком его объедки, кости.
дыгин класпэ манаса̄в тадӯ.	четыре класса закончил там.
эдын ачин бичон энинӈӣв.	мужа не было у моей матери.
куӈакар hуюкур биӈэhӣтын-тэ, этэсов стадэлдӯ hавалдямӣ.	дети маленькие когда были, перестал в стаде работать.
сундӯ эдӯ, эдӯ ороко̄р вон биhэ.	у вас здесь олени.
дэ̄.	да...
часовнядӯ индеӈкӣтын	в часовне они жили.
эр тодёдо̄hун, hэлэ эмэпдем ирэкселвэ... ирэксевэ, о̄hалба, эр са̄тырэ ирэксэвон, эван.	чтобы вы поверили, я принес шкуру, камусы, шкуру и тому подобное этого песца.
уже инӣгэрэн орорви.	уже развьючил своих оленей.
пэктырэ̄чэ̄н чипка̄рвэ, улукӣлвэ, дянтакӣлвэ вес.	настрелял соболей, белок, росомах всех.
э̄, долго уже, долго, о̄й гороё итыга̄деӈнэрэвун, саво̄далвэр гороё инӣпдеӈнэрэв, гороё еще.	долго уже, долго, долго собирали вещи, долго вьючили , долго еще.
****	****
нуңан балдиса̄н нѓэкэндэдӯ hэгди, hэгди, hэгди экундӯ.	она родилась в эконде в большой, большой, большой этой самой .
амӣм дылганман урэ̄дерэн.	походит на голос моего отца.
варак hо̄гинипкӣ:	враг пинает:
потом амӣ эмэрэн.	потом отец пришел.
****	****
ну, та̄ла̄ hурурэ.	ну, пошли туда.
тар hэлэ умно̄, дэгилчолон, думайдеса тар бэе.	вот, однажды, когда тот улетел, этот человек подумал:
ая хава тарэ».	хорошая работа это».
бэелба одявкӣ ситадук.	делает людей из глины.
тадӯвэр лукӣлви дяяналви савуриhинивкӣ туксамнӣнка̄кундук, нуӈарнунтын ганатма̄силча.	потом стрелы, которые спрятал, схватил на бегу и начал с ними перестреливаться.
гиркулча тарэ дундэ hэргӣдо̄лӣн.	стал ходить под землей.
дяпкун класпэ манапка бисён.	надо было закончить восемь классов.
эмэдерэ ēкунмал.	едут по направлению ко мне какие-то.
тозовкава га̄мэ.	взял тозовку.
"одяңа̄с, — гунифкӣл, — бригадир".	"будешь, — говорят: — бригадиром!"
уринэңнэрэв.	останавливаемся на однодневную стоянку.
ну, ургэ тэгэтчэрэн гулувунми дагадӯн эдынунми.	ну, беременная сидела у очага с мужем.
аминңэhэ, нуңандар на̄дан аңаниси бинэ, асин о̄сан.	покойный отец умер, когда ему было шестьдесят семь лет.
но, кунто опка̄нди, мо̄м гурудием обратно.	но, перевернув, сама буду грузить  обратно.
куӈакар әмәрә учамила̄.	дети приехали в учами.
****	****
а, для них?	а, для них?
так изредка.	так, изредка.
депдеӈкӣвун.	ели мы.
«эдӯ инилдерэс.	«здесь будете жить.
****	****
голово мōлаңнэрэвун, успеваттиңнэрэвун нāртэдӯ.	бревно готовим, дрова, успеваем на нартах.
пау.	
«эвунаи исефкэ̄сэ̄с»? — гуннэ.	«зачем ты показала?» — спросил .
ой, как орēллав.	ой, как мы закричали.
албача аһадямӣ.	не смог догнать.
****	****
о̄кир бакача̄с?»	когда нашел?»
****	****
тэгэконэм, мо̄лдӯ тэгэтчэрэн.	сел и сидит на дровах.
нуңан гунчэн:	она сказала:
ну уллэ, конечно, оллол тугэ.	ну, мясо, конечно, рыба так.
****	****
эрэ индеӈкӣвун на рыботочках калан, делимакит, перекат.	это, мы жили на рыботочках калан, делимакит, перекат.
хавалим хагдандула̄йӣ.	работала до старости.
просто дю нуӈардула̄тын оёлэ̄тын бурурэн, эдындерэкин hо̄мамат.	просто чум упал на них сверху, когда был очень сильный ветер.
«миндӯ бичэн... би hэгди бичэв, миндӯ бичэтын hутэлви уже.	«мне было... я взрослая была, у меня были дети уже.
уже hалгарин это, в землю проваливаются.	уже ноги у него в землю проваливаются.
колледжвэ этэрэн мирныйдӯ.	колледж закончил в мирном.
да.	да
аӈи, бӯнӣдерилвэ иргичилвэ до̄лдӣрэв.	это, воющих волков мы услышали.
вот тадӯ би и балдиса̄в.	вот там я и родился
бӯ пэктыруллэв.	мы выстрелили.
би тар до̄лдӣм аӈидерилвэ, бӯнӣдерилвэ ӈэ̄лэвсы-ко̄.	я это услышала, этих воющих страшно.
а уӈун тар часовнягит эмэпкӣ бичо.	а этот самый  из часовни приезжал.
тадук, ну, аямамат hэгдыhэсо куӈакан.	потом очень хорошо вырос ребенок.
тадук оленевод о̄дам мэ̄клойи.	потом оленеводом стал сам .
****	****
давай палаткаткӣ тукса̄хинам.	я давай бежать  к палатке.
эңнэкордӯ ӯчадяңкӣф хивудактӯ.	на телятах каталась верхом от скуки, от нечего делать.
вертолетил дэгиңкӣтын оленеводилдула̄.	вертолеты летали к оленеводам.
вот нуӈан потом опять тар же местола̄ эмэрэн.	вот он опять на то же место пришел.
дундэӈдулӣи hурурэн-да̄, «эртыкӣ-кэм дюлби бисётын», — гуннэ.	пошел по этой земле, думая: «вот в эту сторону мои чумы были».
эрукталиңкӣвун гиркуматпэл.	начинали проверять пешком.
бэелэ асир.	людей других нет.
****	****
ама̄ка̄н лукӣлон о̄са бэетко̄ндӯ, элэ нӣко̄р, уставатын.	дедушка сделал мальчику стрелы, все это самое , все.
тадук бэе эмэлчо дюмала̄.	потом человек пошел к чуму.
ламбара̄нэн.	прилепила.
тадук нуӈартын эта... hэвэкӣдӯ... гундерэн:	потом они... бог думает:
истанокил бэйэл экур уполномоченнийил гиркудяңкӣтын.	станки, люди эти, уполномоченные, ходили.
****	****
тэпкэлиӈкӣн:	звал:
ёсал-да̄, «бэеёй, этэкэл, этэкэл, этэкэл! — гулчэл тар бэевэ, алтасилчал. —	испугались и стали говорить тому человеку: «дружок, перестань, перестань перестань! — стали умолять. —
нуӈан мунэ тэвӯктэдесо̄н ило̄ та̄ла̄.	: нет в аудио.
— багдама орон эрӣгин аhӣс буслэ олдондӯн.	— пусть белый олень подышит твоей жене на больной бок.
тар это hа̄рги аӈин — ой, варак — только тэпкэhинэн.	черт, то есть сатана только крикнул:
би гунэлим:	я стала говорить:
вертолетил о̄ра, дэгрэ.	вертолеты это самое, прилетали.
мм.	м-м
тадук этырко̄нин будандэ̄, потаптула̄ hурурэн.	потом ее муж умер, и она уехала в потапово.
нуӈан hаӈӯктаса.	он спросил.
тадук шурая тымāнэктэван, эва, «буранилди» һуручол.	оттуда шура и его друзья это, на другой день на «буранах» уехали.
тадӯ больница бисо̄н.	там больница была.
ило̄ о̄да?	куда они делись?
тар hэлэ, тар hурумурэкин, олдан тарэ уӈтувунэ эhӣ тар бэе.	как только он улетел, тот человек стал делать бубен.
ну тар бэе, который ӈэнэдечо̄н.	ну тот человек, который шел.
так до зимы, зимой уже аргишим на одном месте.	так до зимы, зимой уже аргишим на одном месте.
ну там ганалчи-тэ hо̄ биӈкин бэе.	ну там стрелок-то он сильный был.
эдӯ индеӈкӣн минӈӣ эким, ольга ивановна, удыгир этырко̄ндулӣви.	здесь жила моя сестра старшая ольга ивановна, удыгир по мужу.
ага.	ага.
но индесо̄вун аят.	но жили мы хорошо.
оленеводил хуңту измени= изменирэ оронми иргихӣтпэ.	оленеводы другие изменили воспитание оленей.
чайтырэвун.	попили чай.
умуко̄н бэе, тутончанэган, миндӯ улгучо̄нэн эро.	один человек из тутончан мне рассказал это.
«он нян ӈэлифкэ̄нми ая бино̄н эр hутэлвон, минэ дэгивдо̄тын дундэткӣ, тарэ дюв дагала̄н?».	«как бы напугать было бы этих детей, чтобы они привезли на землю, возле моего чума?»
дядаңилва, дядаңилдӯ илэлдӯ ороройи буңкӣн нулгӣктэвунэтын, дебдо̄тын.	безоленным людям оленей своих давал аргишить, чтобы те ели.
би до̄лдӣм тар бӯнӣдерилвэ, аӈилва, ӈо̄нимилва.	я услышала этих воющих, длинных .
****	****
и вот мунэ тар северный таймура арчаран оллолди, бэйӈо̄лди, чипка̄рди.	и вот нас северная таймура встретила рыбой, дикими оленями, соболями.
нуңардӯтын кэтэ hутэлин бичэтын.	у них много детей было.
тадук хэлэ э-давэл этэрэ эрэ, бу хагданэв.	потом вот почему-то не стали, мы постарели
туксантеса-до̄ — тэтыгэ̄дукин, hогдондодукин дэгивуhисе эрдэло̄н яӈилтыкӣкӯн,иhэлдуло̄.	побежал — за одежду, за спину его совсем понес на горы, на камни.
тар место ая-тэ.	там место хорошее-то.
ну тогда hэвэкӣ гундерэн:	ну тогда бог говорит:
ичэчэлим.	стала смотреть.
hукулэ̄девкӣ.	лежит.
уллэ аямама бичо̄н.	мясо было очень хорошее.
умуко̄н тыгӣсе егин нямади дяпкундяр надысидӯн аӈанӣду эмэсо̄в.	в одна тысяча девятьсот восемьдесят седьмом году я приехал.
потаптулā ирэ̄мо̄дичэ̄в.	в потапово в гости я поехал.
всё равно уже почти что половину тугэ, hа̄лватын, аят эчэв hа̄рэ.	все равно уже почти что половину, так, некоторые  уже хорошо не помню.
экспедициядӯ hавалдэса̄н, hавалдэса̄тин.	он работал в экспедиции, они работали.
****	****
«тар hэлэ, hэлэ hуруктэ — гусё. —	«ну вот, пойду-ка, — подумал он. —
****	****
hот тарит но̄данчэдем».	хоть этим кину».
«нӣ эмэсе̄н?» — гусё.	спросил: «кто пришел?»
го̄сӣктаван hэлэ hурум армиела̄.	на следующий год вот пошел в армию.
тэгэтчэчо̄н.	сидел.
ну а би потом дагама̄м.	ну а я потом подошла.
****	****
тар ӈэлитнэ бэе, билдэн тар киӈгиттӯ.	человек стал жить у того кингита, боясь его.
а бучэн нуңан умукон тысяча йэгиндяр дяпкун нуңу... нуңи... нуңидӯ аңанидӯ.	а умерла она в одна тысяча девяносто  восемь  шестом году.
ну а нуӈан тэгэтмэ тадӯ эмэ̄нмучо̄н.	ну а он там остался, сидя.
ну индичōвун тāду дю̅лдутын, балокилдутын.	ну жили там в их домах, в их балках.
тариӈилби дяюка̄тчэвкӣ.	он прячет их потихоньку.
ну нуӈан гундерэн, что вот от этого, чтобы маленького пальмой рубили.	он говорил, что вот от этого, чтобы маленького пальмой рубили.
э̄-да̄ эдендэ?	почему нет?
этырко̄м гунэпкӣ.	мой муж говорит:
би hаңуктэдеча̄в эбэкэйэ аннадук миhайловнадук:	я спрашивала у бабушки анны михайловны:
****	****
таригит эмэчол бичо̄тын потаптула̄.	оттуда они приехали в потапово.
hактыривчу о̄дан.	темно стало.
hо̄вэ горово ганатма̄тча.	очень долго стрелялся.
лукӣлви савуриhиса-да̄ лупоро̄са.	стрелы взял и вышел на улицу.
оӈкодёро.	пасутся.
hэвэкӣ дявусадяса-тэ нуӈанман.	бог ее держал.
тадӯ это, ичэтчэм-дэ̄.	там посмотрю.
hурупкӣко̄кун, илкэ̄ндепкӣ.	уходя, они делали зарубки.
эвкӣл эйдэрэ нуӈанман.	его не замечают.
грибылва та̄пдяра.	грибы собирают.
тадук до̄лдӣм тэпкэ̄рвэ.	потом услышала крики.
и ӈинакир миннун сурурэ, ёлки.	и собаки со мной пошли.
****	****
тāдӯ һāлвэтын тaйим: знакомыелби бичōл.	там некоторых узнал: знакомые мои были.
ичэм: волка удялин тадӯ везде ча̄гит.	увидел: следы волка там везде, с той стороны неподалеку.
дундэло̄ эмэврэн и гундерэн:	на землю привел и говорит:
это hуюкуко̄н гē, игдямака̄н.	маленький другой, рыженький {цвет совсем маленьких лосят}.
тариӈми ганасивкӣ-да̄, идӯ-до̄ эвкӣ на̄вканэ.	стрелял в него, никуда не попадая.
би уситтяса̄в дяпкун класстӯ.	я училась в восьмом классе.
hутэлин-да̄ монин-да̄ ёсал эрэгэрит.	дети же сами очень испугались.
аhӣв гэрбӣн маша.	жену зовут (=жены имя) маша.
****	****
южной таймурава да̄грав баргида̄ван.	южную таймуру перешли, на другой берег поднялись.
гошаядӯ, наверное, тадӯ куӣко̄тчэркэл, кикитчал.	у гоши, наверное, там дрались, покусали.
удялтын ачир.	следов нет.
потом гēва мо̄тыва ичэрэв.	потом видели другого лося.
тадук болонӣвэ тагӣктам, орорво го̄тадяна.	потом всю осень пас (оленей), изгородь делал.
дэгилдэ дюткӣкӯнмэр тар киӈгит hутэлин.	полетели себе домой дети кингита.
интернаттӯ хавалча̄в.	в интернате я работала.
амардулӣвун аһача бригадиритын.	по нашему следу гнался их бригадир.
аӈулда, диволда, гуннэ:	стали удивляться, думая:
тадук тогоӈнэрэв дявилтыки и шуруӈнэрэв ошолоки улумикиттики.	потом садимся в лодки и уходим вверх по течению к промысловым местам.
дяваттэн нуӈарватын.	похватал их.
ой, нуӈартын гара тыгэвэр.	ой, они взяли свою посуду.
****	****
****	****
тадук до̄лдӣрэн энӣӈэhэв:	потом услыхала мать покойная:
стāдэвэтын дарӣлӣ нэнэчо бэгэ̄м, дарӣлэ дю̅тāдечэ̄л.	их стадо стороной я проехал, в стороне были в чуме.
кирэ, ңо!	фу, вонь!
туӈ никэсэ-да̄, hэлэ би эhӣкоко̄н нуӈарватын ӈо̄лэфко̄ндеӈо̄в», —	«делая так, я их сейчас испугаю», —
нуӈан гундерэн:	она говорит:
уставан манавкӣ, ва̄вкӣ.	всех приканчивал, убивал.
«"койно биhим" — гундерэн».	«говорит, что заблудился».
поэтому тогда аямамат абгара̄л биӈкӣвун.	поэтому очень хорошо здоровые были.
куӈакан тар моӈӣлди лукӣлди куӈакар hутэлвэтын hоёлдулӣтын гарпануса̄н,	тот ребенок пошел стрелять своими стрелами детей в лоб,
орор эдӯ же эмэчулэ .	олени пришли сюда.
кабинэтэлдӯ тэгэттанэ эдиңо биңкӣв гороё .	в кабинетах сидя, не мог там долго .
тэр...вэгин эрэ перестройкало̄ӈаhӣтын, то̄лӣ hэлэ ӣн эрувсю осян эдӯ, екэӈдэдӯ, перестройкадяӈаhӣтын.	в то время, когда была перестройка, тогда вот жизнь плохой стала здесь, в эконде, когда перестраивались.
би тугэ аӈидяӈнам , дюла̄и ӈэнэдеӈнэм толгокӣлдӯ... толгокӣдӯ.	я зимой это , домой еду на санях.
тэтыгалин асир, ēкунда асин.	у него (=его) одежды нет, ничего нет.
орорди бидянэ, орорво тахӣктадядяңа̄с.	с оленями находясь, оленей выпасать (=перегонять) будешь.
лекарстваңилтин ңо̄пчу.	лекарства их (оленей) вонючие.
****	****
****	****
орорво унятча̄вун тиңариңэ.	оленей продали в прошлом году.
орорди сурурэв.	оленями поехали.
****	****
ӈо̄лэлим аха.	я испугалась, ага.
аяка̄нди уйдэн ухӣко̄кунди.	хорошенько связал веревкой.
ӈэнэктэдендэ тадӯ нуӈанман.	поведу-ка его туда.
туша̄л улдэлви столько.	туши, мяса моего столько.
тар исевкэ̄сё, «эр бидерэ!», — гуннэ.	она показала, говоря: «вот они!»
оводылвэ уставан ва̄сифкӣл э э̄курди, брызгователди.	оводов всех убивают этими, брызгателями.
потом буссэлдэн ленинградтӯ, эмэрэн дюла̄и.	потом она заболела в ленинграде и приехала домой.
ēкука̄кун-мэл, гундерэн, hэлэмэ чипича до̄рэн hэгдымэмэ, гиргинадяна.	какая-то, говорит, железная огромная птица села, позвякивая.
hэвэкӣ hэлэ аӈилдук, ситалдук одявкӣ бисе бэелбэ.	бог вот из этого самого, из глины делал людей.
нет.	нет.
тар бэӣтчэрэн тар демӈэнэдукпи.	он мстит за свои объедки.
так тугэ, просто, дебдо̄вэр, дебдо̄вэр, гэлэ̄ктэдечо̄вун бэйӈо̄лэ, нулгӣктэденэл.	так просто, чтобы поесть, чтобы поесть, искали диких оленей, пока аргишили.
"хинңӣс опытис хэгди".	"у тебя опыт большой".
hаңэдефкӣл депдо̄вэр, нулгиктэдедо̄вэр.	следовали за ним, чтобы есть, кочевать.
пэктэрониңнэндэ сипканмэ.	стреляешь соболя.
«hэлэ, ӈэнэдекэлду.	«вот, идите.
эвкӣ hилбэрэ ама̄ка̄.	не рассказывает дедушка.
нонон аӈӣнкӣф неӈненӣт мо̄лэ оёнмуно̄ӈкӣф.	перед этим это делал, весной дрова сплавлял, несколько раз ходил.
ну бидеӈкӣвун так-то эрупчут.	ну, жили мы так-то трудно.
а эрэвэр школьник бичо̄н исколэ дудинкадӯ.	а этот  школьник был в школе, в дудинке.
минӈӣ сестрав hэгдымэр турская христина дмитриевна эдӯ hавалча̄н.	моя старшая сестра турская христина дмитриевна работала здесь.
войнадук бичо̄н куйкӣ.	с войны был глухим.
угискӣко̄н дэгилипкӣ дундэ.	земля летит вверх.
кэргэhэлин эрэгэрит hокорсёл, «ило̄ одан эр? — гуннэ, —	семья совсем  потеряла, говоря: «куда он делся?
тадук энинмэс hуруврэ.	потом твою мать увезли.
****	****
дядя амаскӣ hурурэн.	дядя позади поехал.
бороӈкон гэрбӣсӣ амакав, бисён муктэӈу(л)дук.	дед по имени боронгкон был из рода мукта.
hамнӣhэлэ оро... ол... о̄лиңнэм.	дымокуры делаю.
бадаралтин бадарами-тэ, — гунифкӣ, — дундэвэ.	"лесные пожары, поджигать лес стали",  — говорит .
ну, илэдыт.	ну, по-эвенкийски
****	****
то̄лӣ амӣм орирэн hама̄нмэ утокогир баhилайвэ.	тогда отец позвал шамана утокогира василия.
такую даль эхӣ.	такую даль сейчас.
hомо̄тыва би расскажу, он ва̄ча̄в.	медведя я расскажу, как убил.
палаткала̄ дагама̄ллавун:	стали подъезжать к палатке:
****	****
«э̄, тунӈава бэева hиhур... кэп... э̄, уим.	«о, пятерых мужчин я связал.
****	****
удядӯ hинэ бэлэдям, ну, защищательдем.	по дороге буду тебе помогать, защищать».
он о̄дям би?»	как буду?»
халгартин кэпусол бисо̄тин.	ноги их опухшие были.
тугэнӣвэ тагӣктаравун мартэлдула̄.	всю зиму пасли, до марта.
«кэ, пэктырэ̄кэл, бэе!»	«давай, стреляй, парень!»
горово бикэнэм, hэвэкӣ эмэрэн.	бог пришел после долгого отсутствия.
эр портала̄ эмэллэв —	стали подходить к этому аэропорту —
албарав эя-да̄ аӈидями, ва̄дями, ни бэйӈо̄л.	не могли ничего добыть, ни дикого оленя.
хоктэлвэр тэр нуӈартын эсэл ха̄рэ.	дорогу свою они не знают.
вертолеттӯ дәгилдәв.	на вертолете мы полетели.
тартыкӣ туктыhинэн.	залез туда.
уллӣдеӈкӣн коколлолва аӈидук, ирэксэдук.	она шила рукавицы из этого самого, из ровдуги.
выходной	выходной
их же, нямалчада, эдын асин.	их же , прояснилось, ветра нет.
****	****
все.	все.
амӣм то̄лӣ буслэлчо̄ бисё̄н.	отец тогда заболел.
****	****
дюктэкон индевкӣл.	вдвоем жили.
hукулэ̄дерэ, hукулэ̄дерэ.	лежат, лежат.
эпэт hурурэн.	опять ушел.
даже гунипкӣл избушка гуру, избушкабал эчол эмонэ, что ли.	даже, говорят, избушку какую-то не оставили, что ли.
туӈ никэвкӣ-да̄, ēкун-мал мӯян гэнно̄вкӣ идук-пэл бисё.	делая так, ходил ему  за водой.
акӣм бисо̄н, алекса̄ гэрбин, александр.	у меня был старший брат по имени алекса, александр.
****	****
ну умно̄т аӈиран, пэктырэ̄нэн нуӈанман.	ну сразу это, выстрелил в него.
нуӈан гунэн:	он сказал:
потом долдым, «м-м-м» некэдерӣвэ.	потом услышала, как делает «ммм».
то ая, аямамат долса̄тча-дэ̄:	хорошенько прислушалась:
****	****
ē бихэ.	да, они  есть.
бӯнӣллэ тарэ аӈил, ӈо̄нимил.	завыли эти «длинные».
больше омӈом.	больше не помню.
этырко̄нин нуӈанӈӣн удыгир владимир константинович.	ее муж — удыгир владимир константинович.
****	****
****	****
ну эхӣ эхӣ эхӣтэ город тадӯ.	ну сейчас, сейчас-то город там.
тадӯ марил, якталӣ дынӈӣлэ̄чо тадӯ.	там кусты, вдоль ручья он бежал там.
тэрэhэ̄денэ, туксаhисе нуӈанман.	побежав, колотит его.
«да, би, — гундерэн — амутва упкатван hурупда̄и, тар hунӈӣ тыгэhун hуюкӯн эӈэнӣ».	«да, — говорит, — я все озеро принести , но ваша посуда слишком маленькая».
ичэчэлим аямамат.	я стала хорошенько смотреть.
ну, бедненько	ну, бедненько
да.	да.
— то̄лӣко̄ркэ, бэе, илмактал хуна̄тка̄рвэ ахакталиӈкӣн, — гунденэл.	говоря: "тогда-то, человек , молодых девушек гонял он"
ӯчакки дявамалчам, мэнӈӣви ӯчакки.	учака схватила, своего учака.
«амаргӯт о̄кинмэл эмэдем.	«позже я приду.
hэлэ, думайдяна, думайдяна, тар бэе аӈча.	вот этот человек думал, думал и это...
нуӈандӯн тарэ hава̄линэ правителство бусён дюр орденмэ трудовой славы, второй, третьей степени.	ему это за работу правительство дало два ордена трудовой славы, второй и третьей степени.
"эр экспедициял о̄ра hутэлвэв буфконэ.	"эти экспедиции сделали, моих детей задушили.
һōйдук мучӯча.	из тундры вернулся.
однажды, умно̄ этырко̄м, умно̄ этырко̄м аӈиран, бакаран абдунма.	однажды мой муж это самое, нашел берлогу.
«иниhилдерэс!	«живите!
тадук hуидыгиф аhатканӈиф дюга балдиран, валя гэрбӣси.	потом младшенькая девочка летом родилась, валя по имени.
****	****
****	****
мо̄лкэвутчам.	мне померещились призраки.
бурдука а̄син.	муки нет.
hа̄рги-лувар-ка, тар исесё-до̄, тумниса дэрэлдӯтын тариӈилдӯн, тар hэвэкӣ бэеӈилдӯн.	черт-то, когда их увидел, плюнул на их лица, на лица этих самых, людей бога.
уто̄лэ-тэ эhӣ-дэ орордӯйӣ hердӯтын, hе̄рватын минэфкӣл эдэвэр hокордэ... hокормӣ тарво оронэ, бакада̄тын, бакада̄вэр.	раньше и сейчас оленям на ушах, уши режут, чтобы не потерять, если потеряют этого , найти чтобы, чтобы найти.
тэр эӈнэко̄рвэ нуӈардула̄тын тастяса̄вун, оhотникилдӯ буттотын, булта̄мнилдӯ.	тех телят мы к ним гнали, чтобы они раздали охотникам, охотникам.
эрупчу хуруврэн.	плохо, увез он.
долбо тадӯ иhэлдӯ нуӈарнунтын а̄вкӣ.	ночью там на камнях с ними спит.
****	****
тар hэлэ умно гэнно̄hисё, бэелвэ оканэм, аӈъя, мӯя.	вот это, однажды бог, сделав людей, пошел за этой самой, за водой.
«ӣла нуӈартын о̄ра?	«куда они делись?
«огдоскэ̄!»	«дуся!»
игаркадук эло̄ приходили орорак угуччанал хантайкала̄, тар хинэ нянчитчикаеми.	из игарки сюда переходили, ехав верхом на оленях, в хантайку, когда тебя  я нянчила.
тогда то̄лӣ ичэно̄синэв севернай таймурала̄.	тогда, тогда поехали посмотреть на северную таймуру.
то̄лӣ ӈинакин туро̄си бисё.	тогда у собаки была речь.
и вот би туг хавалим.	и вот так я работала.
тадӯ би исдечэв: нуңан бичэн э балдичан примэрно умукон тысяча дяпкундяр дяпкун нуңидӯ аңанидӯ.	там я видела: она родилась в тысяча восемьдесят  восемь  шестом году.
яӈка̄кӯндула̄ эмэвсо, иhэлдула̄.	на горы принесла, на камни.
би-кэ чо.	я-то что.
****	****
«тэгэкэл!	«садись!
нуӈан даже гуниӈкӣн, в берлогэ эпко̄ ва̄рэ... абачӣ.	он даже говорил, в берлоге нельзя убивать... медведь.
дюн ачин эчэ аӈидяра, о̄пдерэ.	чум не построен.
hо̄дыh тарэ орорво таhиктамнитын эрэ екэӈдэвон.	он лучший пастух оленей в эконде (=экондинец).
а тāлā телеграммувэ бакачāл потом уже, ушли, когда уж давно һаваичалāвун.	а там телеграмму нашли потом уже, когда уже мы давно ушли гулять.
аямамат охотилсядеча̄в.	очень хорошо охотился.
и вот гунэн:	и вот он сказал:
и все.	и все.
ча̄скӣ hурурэвун.	дальше пошли.
тартики угусакит хуруңнэндэ.	туда верховым идешь
мо̄ртын, мо̄ртын ачир.	самих нет.
****	****
туӈадян орорво.	пятьдесят оленей
потому что эрупчуе дептылэе, который эсӣко̄тко̄н депдеӈнэрэ, эӈкӣвун деврэ.	потому что плохую еду, которую сейчас едят, мы не ели.
ну и эмэпчо̄тын нуӈанман ербэкэдӯ.	ну и привезли его в ербогачен.
тар амӣӈаhав эмэрэн омолгӣнун {степан тыптагир}.	отец покойный приехал с молодым человеком {степан тыптагир}.
городтула̄ индям, дудинкадӯ.	в городе живу, в дудинке.
хэгды, кэтэ оросӣл эвэнкӣл hутэлдӯвэр анаңилэтын эңкӣтын, бӯңкӣтын нямисанэ.	эвенки, у которых много оленей, это делали, давали своим детям важенку.
тарит-дэ̄ нуӈан гундерэн:	потом он говорит:
тадук тариӈин...	потом тот...
акинми андрей бусэн миндӯ дяпкун ирэксэвэ элдӯндайи о̄дав.	старший брат мой андрей дал мне восемь шкур покрышку чума сделать.
иртыкӣ бирэн дюс?»	где находится твой дом?»
ӈэнэденэ, ӈэнэденэ, дюкчалвэ исесё дундэгэсин-тэ̄.	шел, шел и увидел чумы, как на земле.
куңа= ңэнэвуңкӣф бэйэлво.	я возил людей.
орохэмэ, орон хэгди умнэй.	что касается оленя, олень очень умный.
hурур... ачир о̄ра.	не стало их.
улдэӈилтын локусадявкӣл тулӣло̄.	мясо их висит на улице.
надо с утра же хурурэктын.	надо с утра же ехать .
ну, аят бидеӈкӣвун.	ну, хорошо мы жили.
конечно, конечно, все время.	конечно-конечно, все время.
но пэктыро̄кэл аямамат».	но стреляй очень хорошо».
дяндук дюлдо хэлэ-кэ ңэнэдеңо̄̄тын.	за двенадцать дней доедут.
энӣңэhэ гуниңкӣн:	покойная мать говорила:
hурурэ эрдэло̄н.	ушли совсем.
абачӣ тэгэрэн.	медведь сел.
гаса мо̄ка̄нмэ, гуннэ:	взяла полешко, думая:
— тар киӈгит гусё.	— сказал тот кингит.
бӯнӣллэ-hэ урэгэ̄ндӯ, урэгэ̄н оёдӯн.	завыли на горе, на вершине горы.
тадук дудинкала̄ хурум.	потом в дудинку поехала.
туңивэ-нэ миндӯ ту= туңэва отмэткава бӯпкӣл, пятёркэлвэ полушишя̄в, энэ гирамэтнэ бихэ, монңӣтпӣ опытитпӣ хавалнатпӣ орон хававан.	пятерку вот, мне отметку пятерку дают, пятерки получал, будучи неграмотным, со своим опытом, с проделанной  оленьей работой.
туруhанскэдук целый аңанӣвэ эмэдэфкӣ ңэкэндэла̄.	из туруханска целый год возвращалась в эконду.
«эдес дэгивуhинэ-да̄, эрит ваттиӈа̄в hунэ» — гусё.	«если не унесете, поубиваю вас этим», — сказал.
«он кэден ёпу бирэ, тарба бэевэ иргӣтчэрӣ нуӈан?»	«как же ему , кормившему того человека, не быть жидким?»
****	****
да.	да.
hэвэкӣ hурурэн.	бог ушел.
ēкунка, наверное, ӈинакир кикиркал, куӣко̄тчэнэл.	это самое, наверное, собаки покусали, когда дрались.
эвэдыт турондерэв.	по-эвенкийски разговариваю.
амиңэhэв эфкӣ мэниклэйӣ бу... буфки пушниктӯ.	отец покойный это самое делает, за себя сдает приемщику пушнины.
«эва эчэсун еще горово̄ нулгидисун?»	«почему вы еще не сделали, долго так аргишите?»
****	****
потом ахӣларэн.	потом он женился.
ило̄ идӯ, тадӯ та̄ла̄ хурупкӣ, тара хурупкӣ.	куда, где, там, туда пойдет, сюда пойдет.
амӣм эмэдерэн.	отец мой идет.
эмэнмурэ нэкурви ахамил.	остались младшие мои сестры.
нуӈан а̄дерэн.	он спит.
«койнонун-тэ бирокин, улӣкэл, — гусё, —	«раз заблудился, накорми, — сказал, —
опять тоже о̄hӣктака̄рди опкӣ.	опять становится звездочками.
никӣсе̄рэ эмэвувкӣ.	уточек приносит.
тарэ дяпкун класпэ манаса̄в тутончанэдӯ.	восемь классов закончил в тутончанах.
****	****
эхӣ полно бинорэ, наверное.	сейчас их полно, наверное.
энӣӈэhэв ӈо̄лэлчо.	мать покойная испугалась.
м-м.	м-м.
****	****
ёкэдерэн.	кричит.
охотник бисо̄н.	охотник  был.
экӣнин тоже.	старшая сестра его тоже.
через года... анӈанӣлӣ илаллалӣ... илалдулӣ неӈне талӣ же ӈэнэдечо̄в умукин, на учаге, ӯчактӯ.	через года... через три года весной там же ехал один на учаге, на верховом олене.
****	****
мунэ хурувупкӣ ило̄, дюла̄.	нас возит везде (=туда) в чумы.
как говорят, айяв мэ̄рвэр.	как говорят, выручили самих себя.
****	****
девсо, нӣсо...	он поел и это самое...
****	****
****	****
куӈакан тадӯ hутэтын бисё.	там был их ребенок.
а энӣнми уже дяпкун анӈанӣл как ачин оча.	а мамы уже восемь лет как не стало.
ӈэ̄лэвсы-ко̄, ама-тэ, амавун эвкӣ до̄лдӣрэ.	страшно, это, дед, наш дед-то не слышит.
нянмактал а̄сир бифкӣл.	комаров не было.
«кэ, — гунэн, — бокончукэл нуӈанман.	«давай, — говорит, — догоняй его.
мэндеркаӈаха тавардӯ уӈундӯ тоже дундэгин бичо̄н.	покойный хромой там, в этом, тоже с той земли был.
«тугэ, тугэ де... тугэ, тугэ окаллу.	«так, так делайте.
гунипкӣ:	думает:
гē hуктыллэн.	второй убежал.
этэ̄м, этэ̄м боль..., этэ̄м, этэ̄м, говорю, та̄ла̄ больше аӈирэ.	«не буду, не буду больше, не буду, не буду, — говорю, — туда больше это самое».
а нэкунми василий — а абачутка̄н был... эчэ̄н-тон hэгды бирэ, двухгодовалый — hучуhича котот.	а мой младший брат василий — а медвежонок был небольшой, двухгодовалый — ткнул пальмой.
тадук гуним-тэ...	потом я сказал-то...
дылган-та амӣӈӣв.	голос-то моего отца.
тукса̄дяран, тукса̄дяран.	бежит, бежит.
ну тала эча̄вун-кэ, айча̄вун, ну и всё.	ну, там это сделали, добыли, ну и все.
«тынивэча̄вӯдӯ ӈэнэдечо̄вун.	«мы шли позавчера.
чипка̄рви биhэ.	птицы есть.
би балдычав тутончанаду	я родился в тутончанах.
уже нуӈаннун индеӈкӣвун.	уже с ним  мы жили.
только дирика̄н эмонмучо.	только сопка осталась.
экнӣлвэ таду бидерэ, лена, тоня.	мои старшие сестры там живут, лена, тоня.
дяпкалӣ гиркум.	по берегу я ходил.
хурурэ тāлӣ — дю̅лӣвун ӈэнэрэ.	поехали туда — через наш чум проехали.
потом уже та̄ла̄ hанӈӯкталим.	потом уже там я спрашивать начал.
«hэлэ исефкэ̄кэл миндӯ, идӯ тариӈилин.	«покажи-ка мне, где эти его .
э̅ этырко̄р эхӣ тарилва дёна.	да, старики сейчас тех вспомнили.
би бултадем чипкандули.	я охочусь на соболя
дэгивуфко̄ндеӈо̄в hамий тар дюи дагала̄н.	заставлю их принести меня по воздуху прямо рядом с моим чумом.
эр-до-тэ муданиӈӣв, hэгэним hувулвон.	вот и конец, я рассказал все.
гучовдадо̄и никочо̄в: эмо̄кэл.	хотела сказать: "оставь "
потом ичэсиним амаскӣи:	потом посмотрел назад:
дәгрә самолетту.	на самолете прилетели.
би-дэ̄ эчэ̄в попаллэ.	и я не попал.
«эло̄ миттуло̄ бэе эмэсо̄н, hа̄рги».	«сюда к нам человек пришел, харги».
куӈакан туксаhисе̄ мо̄лоро, оёко̄курвотын, угидо̄лдулӣтын туксаhиндяна.	ребенок побежал, убегая выше вершин .
би гуним:	подумала:
а сейчас я пенсиядӯ бидем.	а сейчас я на пенсии.
****	****
тадук нуӈан уйдэн нуӈарватын.	потом он привязал их.
олдоко̄рво эhико̄н но̄дадем та̄ла̄».	рыбок сейчас брошу туда».
институтылва манаса̄тын.	институты они закончили.
чайникилвэ hуюпчо.	чайники {у нее было несколько, чтобы было больше кипятка} вскипятила.
а гил-кэ уже hэгдыко̄р очал.	а  другие-то уже большие стали.
аямамат бидерэ миттук hэлэкэт"», —	очень хорошо живут, лучше нас с вами"», —
инӣчэдерил бидерэ, инӣчэденэл бидерэ.	запряженными оставались еще.
****	****
да	да
улдилэн о̄даф.	я стала мастерицей шить.
эдӯ экун-ка асин бисо̄н гулэл, гулэл эвкӣ, дюкар тадӯ, эдук, эрбандук нискӣ.	здесь ничего не было, домов, домишки были немножко отсюда внизу.
айисифка̄ буслэвэ оронмо, татарвэн айисифка̄.	лечить надо больного оленя, чесотку лечить надо.
потом умно̄ еще улгучо̄ндерэн.	потом однажды еще рассказывает.
потом ичэтчэрэн: пещера.	потом видит: пещера.
«hэлэ тар-ваhин бидеӈно̄гин.	«пусть он живет!
давай hикилдэн нуӈарватын мӯко̄нди.	стал мыть их  водичкой.
сильно тēтēдӯ, эдӯ-дэ̄ hавалдями-кэ ачин hава.	сильно ни в тетее, ни где-то  работать-то не было работы.
раненыеӈилви ахакталиӈкӣн.	раненых своих добивает .
пенсионерил, старикив минӈӣ пенсионер бичо̄н.	пенсионеры, мой старик пенсионером был.
би гундем нэкундӯви:	я говорю своему младшему брату:
****	****
энинми гаран-да̄, ама̄ка̄ткӣē hурурэн.	мать взял и пошел к дедушке.
«о̄, ёпун-кэмэ hо̄!»	«о, очень жидкий!»
орор.	олени
ганалчил hо̄ӈэтын гусё:	начальник стрелков сказал:
тадук тастявун нямади эӈнэко̄нмэ, hуюко̄риктэлвэ.	оттуда гнали сто телят, одних самцов.
та̄дук, хиңилгэн буруракин, хуңта орокин, элун, капкасилиңнарав.	потом, когда снег выпадет, когда глубокий будет снег, бездорожье, мы начинаем капканами охотиться (=капканить).
****	****
ну тариӈитын потом опять увӣриврэн.	ну она потом опять поднялась в воздух.
гӯнно, гучо: һāрӣ бэе ӈэнэдерэн.	подумал: знающий человек едет.
****	****
видно, амундярка.	видимо, он испражняется.
илитчэчо̄н.	стоял.
чипка̄ка̄нмэ иседе, "чипка̄н!" гунэктын, амаскӣи тукса̄ндендэ.	видя утку, если говорили: "утка!", ты назад убежишь.
— амэ̅, ēкука̄н ӈа̄лэн харбалдэдирэн тадӯ?	—папа, кого огромного рука ???растопырена там?
уже бумӯдерэ нуӈартын.	уже умирают они.
маӈӣл hуктыдерэ, hира̄ндерэ июньдӯ.	медведи бегут, спариваются в июне.
но hутэлви так-то, дай бог, индерэ упкат.	но дети мои так-то, дай бог, все живут.
туӈ никэсэ-дэ̄, hурусё.	сделав так, он ушел.
гугарэлэ до̄лдым.	гугары услышала.
****	****
эфкӣл онёрэ аhаткар тавэр.	не вышивают эти девушки.
****	****
ну я еще и за лето рассказала	ну я еще и за лето рассказала
эвӣлэн.	стал играть.
потом гēла̄ дюла̄ хуруден.	потом в другой чум поедет.
но так, конечно, мо̄ӈӣв аӈив, чолӣв илэды как, он омӈоденни?	но так, конечно, свой эвенкийский язык как забудешь?
тук кэденэ, абдундула̄ тургам.	так  наткнулся на берлогу.
бу — би до̄лдӣм.	мы — я услышала.
бираду.	на реке
бэевэ hэрэкэт овкӣ.	мужчину отдельно делал.
может, уло̄ккидям как-нибудь».	может, обману как-нибудь».
опять хутэсил.	опять с детьми.
«hэлэ исевко̄ндеӈо̄в, эр hэргӯдӯ дундэдӯ биконэм, эмэм, гуннэ.	«вот покажу, сказав, что пришел, побывав на нижней земле.
тарит тавэр бэе бувкӣ одан тар hа̄рги тумнинадин.	вот люди и стали умирать из-за плевка черта.
гиркуна.	пешком.
би пэктырэ̄нэм.	я выстрелил.
некоторый хагдикар оленеводил тар дявӯседерэ оронмэ.	некоторые старые оленеводы, те держат оленя.
а только hагданми, о̄са̄н рыбаком.	только состарившись, он стал рыбаком.
хуркокочо̄нмэ элэ элэ̄лӣ оча прямо бэдни.	вот как мальчик как раз прямо стала, бедная.
тавуңнэрэвун, потом утром  ня̅н һаңкэлдулдулэ̅ намңнэрэвун, ня̅н hуруңнэрэвун.	ставим палатку, потом утром утром опять на санки, на санки кладем, опять едем
****	****
эр уӈун мина амӣним бичо̄н.	это, отец мой был.
умуко̄нмэ бултарэв.	одного добыли.
эмэдеӈнэрэв, эмэдеӈнэрэв.	подходим, подходим.
элдӯ-ка, ну как сказать-то, эти, коммерсанты, комме..., коммесар... коммерсашэлдӯ униэӈнэрэв шобдёрвэ, улукилвэ.	этим, ну как сказать-то, эти, коммерсанты, коммерсантам продаем соболей, белок.
хутэлви эр гулэтын эрэ аят.	у моих детей дом, это самое, хорошо.
дептилэлэ к..., дептилэлвэ ирук... ируктэдаңкӣтин орордӯ турудук кислокандула̄ биралӣ туңускалӣ.	продукты возили на оленях из туры в кислокан по реке тунгуске.
олдонвэн — продуктэлэ эмэвупкӣл, олдонвэн һурувупкӣл	рыбу — продукты привозят, рыбу увозят
гедӯ кэргэндӯ hунңту оронңӣтын hамилкин.	в другой семье другая отметка у оленей.
hуксиллалди гиркудяча̄вун.	мы ходили на камусных лыжах.
ну и...	ну и...
опять амӣм, опять минэ хурупден.	опять отец меня везет.
курē утэ̄лэптыдук ючал давно тар .	давно вышли из огорода.
глушнев михаил павлович бишё̄н, хэгди доктур.	глушнев михаил павлович был, большой доктор.
гē hуна̄диф, рената, индерэн норильскадӯ.	моя вторая дочь рената живет в норильске.
долса̄тчэрэн тэгэтчэрэн.	слушает сидит.
амӣм энӣнмэв hагды hагдытмэр бисо̄н.	отец матери старше был.
а би эмэрэптэ хуннун нюмотчилдэв эхӣлэ.	а я, мы с вами приехали, и я с вами стали соседями, вот.
алик мунэ тāлӣ мумӈэт ӈэнэпчāн вот.	алик нас туда напрямик проводил  вот.
угучакилди раньше ӈулгӣӈкӣвун.	на верховых оленях мы раньше кочевали.
дэгивускэлду дюктэ!» — гусё.	отнесите меня по воздуху вдвоем!» — сказал.
дылвэр алтындеӈатын.	голову отвернут.
«кӣк, кӣк!»	«кык, кык!» {команда, отзывающая собак}
тар дюкчалдула̄ эмэрэн, дэрӯконэм.	устав, он пришел к тем чумам.
сколько вертолет исысса дэгипкӣ эхӣ.	сколько вертолет летит сейчас?
да.	да.
hэргӣскӣ-кӯн бурусо эрдэло̄н.	совсем упал вниз.
ēhав эрупчут ичэпкӣ бичо̄н».	глаз у меня плохо видел».
ва̄рэв то̄лӣ кэтэмэмэвэ уллэлвэ, оллолво.	добыли тогда много мяса, рыбы.
са... садиктула̄ эӈкӣф гиркура.	в садик не ходил.
бултадяндэ дэңкэявэл капкандӯ тагадян.	добудешь соболей(кисл) в капкан попадет.
учичилдә әду hәгды.	учиться стали здесь, большие.
«о, долболтоно эмэдем.	«о, вечером приеду».
****	****
а варак нуӈанман hаӈӯкчадяран.	а враг его спрашивает:
бу амарка̄ндӯн эмэрэв, нулгӣрэв.	мы после него пришли, прикочевали.
****	****
****	****
би, куңакан, бэлэдеңкӣф луху.	я, ребенок, помогал всегда. 
таду индэӈким....	там я жил.
ну монмэ тэтывулдан нуӈан.	ну сам зарабывать он стал.
hалгардии туги эрденэ, олдолво дяваксидерэн.	вот так разгребая воду лапами, ловит рыб.
чинмо̄нэн и hуктыллэн.	отпрыгнул и убежал.
ӈэнэдерэн, ӈэнэдерэн, ӈэнэдерэн — эдеӈо̄ бака... боконо.	идет, идет, идет — не может догнать.
ама̄ка̄ тар этот...	дедушка этот...
бу дагама̄тчо̄в.	мы приближались.
улумӣдесётын.	они белковали.
весь палец вот такой толщиной: жир, сало.	весь палец вот такой толщиной: жир, сало.
да	да
тадӯ дюн бисё тар киӈгитӈӣ.	там дом был этого кингита.
****	****
анан таргасин мӯ идӯ-вэл бисё.	специально такая вода где-то была
может иргидерэ, может.	может, вырастят, может.
hаңуктачав:	я спрашивала:
тадук уже, hагды о̄ми, эло̄ эмэрэн, эдӯ hавалча̄н.	потом уже, старой став, она сюда приехала, здесь работала.
би-кэ тырганӣвэ бултадеӈнэм, гиркудяӈнэм.	я же целые дни охочусь, хожу.
монин опять это, бокончулдэн тар бэева, экун бэе ӈэнэчо.	сам опять стал догонять того человека, который шел.
hэлэ, амининhинче тар аӈи бисё.	отец, наверное, это был.
опять дундэ гороло̄ дэгилипкӣ.	опять земля далеко летит.
потом тāду, стāдолāтын нулгичōвун, нуӈардулāтин.	потом туда, в стадо аргишили, к ним.
гунивкӣ бисё тар бэе:	человек говорит:
акинмэф тар эсо нӣдо̄, нӣдо̄ гада.	старшего брата моего никто не взял.
энинтын укубдегин нуӈарватын.	пусть мать их кормит.
дэгивувко̄ндесё бисё, ойитын укканэм.	заставлял нести по воздуху, сидя верхом.
потом красная речка, тадӯ индеӈкӣвун.	потом красная речка, там мы жили.
тар гулчо:	подумала:
гунэм.	сказала.
и аӈилча, гадасилча.	и это начал, стал гадать.
вот нуӈан уло̄ккида̄и некэдерэн нуӈанман.	вот он хочет обмануть его.
нӣ-вэл ӈэнэчо hалгарди hэгдыӈэко̄курди.	кто-то прошел большими ногами.
экэл нӣдӯ-дэ̄ hэhэнэ гусёв-лувар ».	я же сказал тебе, чтобы ты никому не рассказывал».
иргӣсилда.	вырастили.
как эрко̄н дюганӣ чука балдыран, уже все нулгӣхинэв.	как маленько летом трава вырастет, уже все, мы начали кочеввать.
туг никэсё-дэ̄, hэвэкӣнун гиркӣладевкӣ бисё.	, дружила с богом.
бэлэдеңкӣтын нуңандӯн, орорвэн таhиктэденэ, монин-та таhиктэдеңкӣн.	помогали ему, оленей его гоняя, и он сам тоже гнал.
тадӯ тар умуко̄н дюкчала̄ исё-до̄ тар бэе.	потом этот человек зашел в один чум.
лукӣлви, лукӣлви бира дяпкадӯн тугартын иливса-да̄.	свои стрелы, свои стрелы вдоль них на берегу реки воткнул.
«эр нян ēкун куӈаканин тэгэтчэрэн?» —	«это еще что за ребенок сидит?» —
туг-дэ кэтэ hутэл-дӯ манавра, hуте.... hутэлин энинңэhэйӣ манавра".	так многие дети мои кончились", — дети моей покойной матери кончились.
овсянкилвэ дявуңкивун, дё э̄кун.	овсянку ели, желчь какая.
так-тэ элэ.	так-то вот.
ну, онёков горомомо бичо̄н, балӣ.	ну, бабушка очень долго прожила, слепая.
hилатна, девувкӣ тар улдэе, эмэврэкин.	когда тот приносил мясо, он ел его, жаря на вертеле.
би хуюкӯн бисо̄ф.	я маленькая была.
гунэн:	сказал:
этырко̄н бусләлдән.	муж заболел.
туг-до-тэ хо̄ хэбдяло̄н биңкӣн.	так очень весело было.
****	****
тадук тар тарэ таду-да эмкэев о̄са̄тын hэ̄кидук.	там же люльку мне сделали из большой лиственницы.
тулосиңкӣв капкара.	ставил капканы.
бу-вэхин аят, амия, акин-да аят олдово булта̄ңкӣн.	мы хорошо, отец, брат хорошо рыбу добывали.
пятый экспедиция московской 	пятая экспедиция московской 
hэлэ эрэ президент hуӈту о̄дакин-тэ, путин о̄салан, hэлэ инмун аятмэр о̄са̄н.	вот этот, когда президент другой стал, путин стал, жизнь наша лучше стала.
«кӣк, кӣк!»	«кык, кык!» {команда, отзывающая собак}
вот так и потом...	вот так и потом...
тогда ама̄ка̄в урэлдӯ мо̄тымӣдяӈкӣн-дэ.	тогда дедушка охотился в лесу на лося.
потом аямамат ичэчэллэв-да̄, нуӈан мунтыкӣ ичэтчэнэ.	потом мы стали хорошенько смотреть, а он смотрит на нас.
раньше аминми э̄кун бишё̄н.	раньше мой отец этим самым был.
дяпкунма классыл этэм.	восемь классов закончила.
буранди, гиркуна, киглолди, онтыкин-тэ.	на буране, пешком, на голицах, всяко-разно
тадук это hэвэкӣ еще раз иктэрэн-дэ̄.	потом бог еще раз ударил.
исча-да̄, тар дюкчала̄ hэгдылдуло̄тын исча-да̄, мо̄лдӯтын тэгэсё уркодӯтын.	дойдя до этого большого чума, он сел на дрова у их двери.
элэ̄лӣ стадовэ гнали тухардэдук.	как раз стадо гнали из тухарда.
«ēкун о̄дан?»	«что случилось?»
амариндула̄вэр эмэрэв.	прикочевали на прежнюю стоянку.
амив= аким бишё̄н иван николаевич, николай егорович амин, эни.	старший брат был иван николаевич, николай егорович отец, мать.
орорди хурулдиңкӣф дялнунми, кэргэннунми дӣскӣ орортики.	на оленях (=оленями) уезжал вместе с родственниками, с семьей в тайгу (=вверх по склону) к оленям.
ӈинакиртын аӣвукка̄кӯр hукуло̄девкӣл.	собаки у них лежат очень сытые.
ну, он би оhотича̄в.	ну, как я охотился.
«hа̄рги эмэктэсён, эдӯ бэеӈилбас тумнирэн-да̄, hурурэн — дэрэлдӯтын».	«черт приходил, оплевал твоих людей и ушел — на лица им ».
горово̄ инчо̄н.	долго жила.
****	****
тымāлтāнэ бӯ этыркэ̅нвун дежуридергӯ, һутэлтын адяпкӣл.	с утра мы с мужем дежурим, наверное, дети наши спят.
эӈнэкэл нуӈанман эрэ, эhактара.	не делай это, не трогай его!
****	****
инвалид о̄дам, эр орордӯ э̄дэнэ, хавалдяна, монми угробичэ̄в тугэ.	инвалидом стал, при этих оленях это самое делая, работая, самого себя угробил вот так.
****	****
амӣ минэ тэрӯттан гулэлдуло̄.	отец позвал меня в поселок .
кларадӯ ачин оча̄н нуӈан.	при кларе ее не стало.
амбардӯ бисо̄вун.	на рыботочке амбар мы были.
«эр би hэргӯдук дундэдук эмэм, —	«это я пришел с нижней земли, —
лучамнӣл гиркудяра.	русские женщины ходят.
э̄, ӈинакир тадук арчамкадявкӣ.	эх, собаки потом выходят навстречу.
тадӯ hойдӯ тэгэвко̄сё, дюн исеврӣдӯн.	там на тундре он их посадил, где был виден его чум.
ачир орор тарэ.	нет тех оленей.
****	****
«мӯрэтко̄кун, — гусол, — ёпу, hо̄ ёпу».	«совсем как вода, — сказали, — жидкий, очень жидкий».
оhала моңнӣдеден.	камысы выделывала.
«тэгэмӣе гэнно̄дям уллэвэ».	«завтра заберу мясо».
иртыкӣ-до̄ дэгивдерӣвон тар бэе эвкӣ эйдарэ.	куда его несет  тот мужчина не понимал.
тадук нуӈан hурурэн.	потом он ушел.
эӈнэм нуӈарватын исэрэ туӈа аӈанӣвэ, дян аӈанӣвэ.	я не вижу их пять лет, десять лет.
һаруккар һуктывугинэ тарья̅каклā орорвэтын таӈаһӣчал бичōл.	немного подвыпившие уехали далеко, оленей считать поехали.
бокончучэлдэн нуӈанман.	начал догонять его.
тадук гэ̄ф омолгӣф, сашав тугэ балдисан февралэндӯ.	потом второй сын, саша, зимой родился, в феврале.
а когда амӣӈаhав эмэӈкӣн,	а когда отец покойный приезжал,
би-кэ илмакта бичо̄в.	я-то был молодой.
амтыл амтыл амтылгали.	с родителями.
«эва ӈэливсипчу?» — гусён.	«что страшного?» — сказал.
иллан лапэлди.	встал на лапы.
гундерэн:	говорит:
ӯчакки эрэ аӈим, ӯчакки пустым, ӯчакки.	это самое, своего ездового оленя, отпустила ездового своего.
имурэ̄н э̄ян бичо̄н это.	жир такой был это.
путэвуртин ңо̄пчу.	мази их (оленей) вонючие.
аӈадяка̄рва дяякал, и это, эӈэhӣес бӯдем.	спрячь сирот, и это, дам тебе силы.
куранэк иhэриктэ.	одни только камни.
«нет, далеко, — говорит, — опять, гороло̄ экэл ӈэнэрэ тогда.	«нет, далеко, — говорит, — опять, далеко не ходи тогда.
в сороковом году, в сороковом году родилась.	в сороковом году, в сороковом году родилась.
би гунэм.	я сказала:
тадук мусюм.	потом вернулся.
«ēкунмэ гогодепкӣл туг?»	«кого так лают?»
уло̄кис hо̄! — гусё. —	ты очень сильно меня обманула ! — сказал. —
да эхӣ эр тундрэло̄ бихим прямо как раз бихэм би тоже.	да, сейчас, это самое, в тундру я, прямо как раз, я сейчас тоже.
ӈэнэрэн, ӈэнэрэн.	шел, шел.
би уже кали одам.	я уже большая стала.
огон.	сделано???
хавалим тоже.	я тоже работала.
уӈтувунми гаса.	взял бубен.
дяндук нюӈун анӈанӣси бисо миндӯ.	шестнадцать лет мне было.
"вот проводник!" — гундерэ. — 	"вот проводник!" — говорят. — 
ровдужные рукавицы.	ровдужные рукавицы.
умно улукӣ тагапса̄ биса̄н.	раз белка попавшаяся была.
ӈо̄лэфко̄ндем-дэ̄ — hэгдыл тариӈилин.	испугаю — а они большие.
бэйӈо̄ ирэксэвон, тар киӈгит эмэмнэвон... инӈактаван усса-да̄, дыласа̄ткӣ олгӣса нэпталэ.	шкуру дикого оленя, принесенную кингитом... он подстриг шерсть и высушил на солнце, гладко.
****	****
и гошаядӯ ӈинакирви ачир тадӯ.	и у гоши моих собак там нет.
уставатын манаса, лукӣлватын дявана, гарпавкӣ мортыкӣтын.	всех прикончил, хватая их стрелы и стреляя в них самих.
ситадук бэелба овкӣ-да̄, тадук мӯвэ гэннэ̄вкӣ идук-пэл-да̄.	он сделал людей из глины, потом пошел набрать откуда-то воду.
мучум.	я вернулся.
то̄лӣ hутэлви hуюкукор, экунди-да эдеӈо̄ бисён улӣврэ.	тогда дети мои маленькие, не было возможности их хоть чем-нибудь накормить (=им хоть чем, чем-нибудь накормиться).
тар-кэ ӈинакирви гогодерэ.	вот собаки мои лают.
эдыдукки hукитэе обратно гаран.	у мужа обратно взяла свой живот.
тар hэлэ исевко̄силчо тар уганалби:	вот он стал показывать то, что принес:
о̄hалба ӣсел аhал.	женщины выделали камусы.
валектӯ тар уриндяпкӣл бичол.	в вальке останавливались на один день.
ну нуӈан ичэрэн нуӈарватын.	ну он увидел их.
вот так вот.	вот так вот
хорошо, аӈты ēкун-ка тадӯ.	хорошо, этот самый там.
умно̄ нулгӣсчо̄вун.	однажды мы аргишили.
немулэмнин ӣвкӣл эргэсин».	так они мягко выделывают».
со̄ аят индичэтын.	очень хорошо жили.
туксама биңкӣф би куңакандӯйӣ.	я быстро бегала (=хорошей бегуньей была) в детстве.
тариӈин улӣсо.	та покормила.
«радистка бӣгин.	«радисткой пусть станет.
аӈилин, hēраӈилин толгокӣдӯ бидерэ.	это, жерди {для чума} на санках.
ӈэ̄лэлим.	я испугалась.
сипкамина̄дэ кислокандӯ гунивкӣл деңкэмина̄ди.	охотиться на соболя (соболить), в кислокане говорят: охотиться на соболя (соболить) {**}.
онэдидяңа̄с тариңилви ни-ка, алӣтин, оңколӣтин.	ищешь их по краям их копанины(пастбища).
****	****
ну и ӣду-тону.	ну и туда-сюда.
нуӈан hуктыллэн.	он убежал.
ну а миткит, навэрное, биркэ hэгды самолёт или нло.	ну а по-нашему, наверное, большой самолет или нло.
«воспитывать» — омӈом онэ.	«воспитывать» — забыла как .
с юга.	с юга.
«ēкунма одяндэ?»	«что ты делаешь?»
ēкун нуӈанман эӈэhӣн?»	кто его сильнее?»
мо̄нин ча̄скӣ ӈэнэрэн-дэ̄.	сама дальше пошла.
****	****
бэйӈо̄е эмэвувкӣ.	дикого оленя приносит.
hутәлви hәгдыhарә.	дети выросли.
«эр аhатканмэ эвунавэр гадяс, эва никодо̄н?»	«для чего вы возьмете эту девочку, что вы собираетесь делать?»
— ну, — гунэм, — гошаядӯ биденорэ, наверное.	— ну, — подумал, — у гоши, наверное, находятся.
****	****
орорвун, уч... нямасал акчудяпкӣл.	наши олени, важенки рвались.
мо̄нин эрэ екэӈдэва̄ндук.	сама она из экондинцев.
гусё. —	сказал. —
маӈӣ о̄ран.	медведицей стала.
потом hиhэвэ hэгдыко̄кӯнмэ эмэврэн.	потом принес огромный камень.
****	****
бусён дыгин кластӯ учитӈаhӣдӯв.	умерла, когда я учился в четвертом классе.
****	****
****	****
«эпко̄ зря абачӣва так делать».	«нельзя зря медведя так делать».
ачин эдӯ оран.	здесь  не стало.
ēкун-ка, хорошо, hуручо̄тын.	это, хорошо, они пошли.
ху= хутов бидерǝн та̄дӯ.	ребенок есть там.
минӈӣ эр эхатпи эдеӈо бихим хурурэ.	с моим этим, глазом не смогу поехать.
эдӯ hавалилча̄в.	здесь стал работать.
орорвэ тыниңнэрэвун, весной, в начале июня, чтоб кормились до комаров маленько, набрали  .	оленей отпускаем, весной, в начале июня, чтоб кормились до комаров маленько, набрали.
ой-ой-ой, hарпука̄н.	ой-ой-ой, шутник.
дёниӈнэм: элэтын: бэел, аhал — умунуктэ мунӈӣ дюмадӯвун.	вспоминаю: все: мужчины, женщины — собрались в нашем чуме.
hэгдыӈэми-кэнче бичо̄н, hаг... hагдымика̄н бичо.	он был вроде большим, большим был.
hэвэкӣ гундерэн:	бог говорит:
ну тадук аранканмɔ умишканчэӈнэрэв.	ну потом понемногу выпиваем.
****	****
"оhалвэ монңидакал!" — гуннэ.	"камысы выделывай!" – говорила
ой, ēкун hэгды бичо̄н.	ой, какой большой был.
«ну hо̄ эӈэhӣчиhинчэ нуӈан, ага».	«он очень сильный».
ну, пэктырэ̄лим.	ну, я выстрелил.
****	****
бэлэдеңкӣвун.	мы помогали.
ӈэнэчо... нулгӣдечо̄вун гороло̄, полмесяца, месяц дулинман бēган, ой, месяц.	аргишили далеко, полмесяца, полмесяца.
hуна̄див эдӯ рентгендӯ hавалдерэн.	дочь здесь на рентгене работает.
са̄тырава ӣвсёво гаса.	выделанного песца взял.
****	****
тар эдо... тодёдо̄hун hэргӯдӯ дундэдӯ бисё, — гуннэ, — эрэ эмэвум hэлэ эр о̄hалба, ирэксевэ, са̄тырэвэ эрэ.	чтобы вы поверили, что я был на нижней земле, — говорит, — вот я принес эти камусы, шкуру, песца.
бригадир о̄нэ, хавалдяшя̄в, хавалдяшя̄в.	я работал, став бригадиром.
дюктэ бидерэ.	вдвоем они находятся
то̄ли хулукокон бишо̄в.	тогда я маленький был.
тарит орон кэтэ иргифшё̄н амаскӣ.	поэтому оленей много воспитывали раньше.
боконон.	догнал.
мунэ эпкӣл гада.	нас не берут.
би аӈим, ӈо̄лэлим.	я это, испугалась.
hаялэ идӯдо̄ тукдо̄.	нету нигде так-то.
тадук-та̄ туг-до̄ тадӯ бусо.	потом так-то он там умер.
минӈӣ орорви биӈкӣтын.	у меня (=мои) олени были.
вот тарит надо hэвэкӣвэ всегда помнить.	вот поэтому надо всегда помнить бога.
гундем:	говорю:
эhикокон-до индэрэн акӣм, сашка гэрбӣсӣ, агӣсӣ, нӣсӣ, hутэсӣ.	и сейчас живет (там) мой старший брат по имени сашка, с женой, с этим, с ребенком.
нуӈан гунэн.	он сказал.
экумайэ-да булта̄йи булта̄деңа̄т, оронди хурумӣ.	хоть какую добычу, оленями пойдя, добудем.
элэватын отнесли.	все отнесли.
бурэн-да̄, тар-да̄ манаврэн, ило̄-кэ одян?	так он умер, кончился, куда же он денется?
участок, ну на двоих, ну, дюкчан... дюкчадӯ.	участок, ну, на двоих, двоим.
идӯ нуӈан уринэрэн.	«где он остановился?»
бултарэв тариӈӈар.	добыли его.
****	****
совhозтӯ hавалчав дыгин аӈанӣвэ.	всовхозе работал четыре года.
тāдӯ арчарэвун.	там встретили .
эпкӣ бичэн до̄лдӣрэ.	не слышала.
диктэлвэ уӈкулидеча тариӈмэр.	он ягоду в рот клал.
ӈинакин...	собака ...
кутуйэ асиндӯ эфкӣл балдырэ.	у несчастливого не растут.
дюла̄и hурурэн.	пошел к себе домой.
hуктыммэт век нулгӣрэв.	ехали все время бегом.
тар дундэӈдулӣи hурурэн, hурурэн.	шел, шел по своей земле.
тар hутэлин hаӈӯктавкӣл бисол.	дети стали его спрашивать:
каӈкит мирэним.	быстро вышла замуж.
потом таргит аликйэ эмэчōтын ды̅гит орорди.	потом оттуда алик и его семья приехали из леса на оленях.
ӈинакинма гулчо:	спросил у собаки:
hимула̄вкӣ.	молчит.
«hэлэ этэм», — гуннэ-кэ, эмэнмусо дюкчадӯ умукин.	«нет, не стану», — сказала собака и осталась одна дома.
минэ тавэркэ, эркэ, утом.	меня узнала ли, нет ли 
потапкит бэе нулгӣчо бичō балокитпӣ.	от потапова человек аргишил в балке.
эниңэhэ гундесэ̄н:	мать покойная говорила:
а сюда.	а сюда...
хорошая бабка была.	хорошая бабка была.
тар минӈӣ энтылви, тарэ минэ иргӣдесол, аят иргӣрэ минэ.	мои приемные  родители хорошо вырастили меня.
тāду бичōвун.	там были.
тихисе туңаняма орон батикнэн истадо, воти биңкӣн тӣхисэ туңаняма.	тысяча пятьсот оленей вплотную, стадо было тысяча пятьсот.
тар бэетко̄н удялӣтын hурусо, илкэ̄ндулӣтын.	тот мальчик пошел по следам, по зарубкам.
кэ... кэтэ hуточил бичо̄тин нуңанңилин ан... антилин аминнунин.	ее родители,  с отцом, были многодетные.
нуӈан минэ анача̄н и потом hуктылча̄н.	он меня толкнул и убежал.
«ӣдӯ?»	«где?»
то̄лӣ истанокил бишё̄тын.	тогда станки были.
ну, тукса̄дярав кое-как.	ну, бежим кое-как.
тарит-та тāдук-тэ һуетчōвун, эмэхичōвун амаскӣвэр.	оттуда потом разъехались, поехали обратно.
эркондӯ ичэврит, наверное, биркэ.	отсюда, наверное, видно было.
hурум ичэтно̄м.	я пошел, пошел посмотреть.
«кӣк, кӣк!»	«кык, кык!» {команда, отзывающая собак}
тар мӯт оптыhинивкӣ-да̄ — тариӈилин арувкӣл бисол.	этой водой брызгал, и эти его  оживали.
****	****
****	****
то̄лӣ-до̄ болоктовон аhӣлам.	тогда-то, осень когда настала, я женился.
hэлэко̄кӯнди нуӈанман даснаван оран.	из железа сделал крышку.
как раз бушшэдечо̄в то̄лӣ.	я как раз болел тогда.
****	****
****	****
hавалдерэв чопумошол, ну, шукшилрэ.	ходим, ну, на лыжах.
мо̄ртын hавалдяра.	сами работают.
дундэӈтыкӣи hурулми, hурупдеӈо̄в.	когда пойду на свою землю, унесу.
«этэм аhӯра», —	«не буду трогать», —
аӈ уркэдӯ уючэдедера аӈма, чипка̄ка̄нмэ.	это, у двери привязывали это самое, утку.
hэр hэргӯла̄ дундэла̄ бурум, гиркудяна, эмукин бултаденэ.	упал на нижнюю землю, когда ходил один, охотился.
потом садиктӯ хавалим.	потом я работала в детском саду.
орор манавулда.	олени кончаться стали.
а уситча̄н ленинградтӯ.	а училась она в ленинграде.
ну а так чего...	ну а так чего...
аминми гаса̄н экунмэ, кружкэко̄нмэ чиктилвэ.	"отец брал это, кружечку, бисер".
нул..., нулгӣчōвун-тэ целый нулгӣв, итыкирвӣ ӈэнэвумдэк	аргишили-то целый аргиш, пока вещи свои отвозил он.
нуӈан эмэрэн.	он подходит.
доӈототчэнэ.	замерзает.
****	****
потом эмэрэ.	потом они пришли.
мирисо̄н нуңан аминдӯф, иландяр аңаниси бинэ.	она вышла замуж за моего отца, будучи тридцатилетней.
девугин!	пусть поест!
ну, ама̄ка̄в бичо̄н, онёков.	дедушка, бабушка у меня были.
киӈгит исесё-дэ̄, ӈэ̄лэвсе-дэ̄.	кингит увидел и испугал .
****	****
ну, биңнэрэ таду.	ну, бывали там.
би тоже, би хавалча̄ф это, колхoзтӯ хавалилим.	я тоже, я работала, это, в колхозе стала работать.
тарка̄кунди аӈиллав.	вот ими стали это самое .
тāдук-тā потаптулā  гиркуйичāвун.	оттуда в потапово ездили.
правда, бидерэ, дюр hуна̄дилви мирныйдӯ бидерэ дюр.	правда, живут, две моих дочери живут в мирном.
вот ичэтчэӈкӣв энӣнми...	вот смотрела на маму...
ну.	да.
тадук каhилиса.	потом стал рвать.
о̄кӣва, гунипкӣ, тэгэсим — эсэв hа̄рэ.	сколько, говорит, сидела — не знаю.
hо̄кононо.	жара такая.
экун-да̄ тогда ачин биӈкӣн.	ничего тогда не было.
толи пургалча бисо̄н.	тогда пурга началась.
тар улгусо̄ндеӈкӣтын.	так рассказывали они.
****	****
экэлду никогда, экэлду нӣвэ-дэ аӈ-кэ, обижаттэ!».	никого никогда не обижайте!»
бэел девдерэ, тадӯ остолдӯ тэгэтчэнэл.	люди едят, сидя там за столом.
дяпкун бēгаси бисо̄ф би, хуюкуко̄н.	восьмимесячная я была, маленькая.
а, м-м.	а, м-м.
нуӈан пэктырэ̄рэн.	он выстрелил.
орорво исэсиӈкӣн	оленей посмотрит
э̄, тар ӯчакилин hуктылчэл тук-ко̄н.	а те учаки его убежали вот так.
****	****
орорво гәнноhинәв.	оленей отправились забирать.
«о̄, эӈэhӣв ачин».	«о, у меня нет сил».
э аӈи эр, гундем, ая бичо бимчэ.	это, это самое, говорю, хорошо было бы.
ура̄м.	промахнулся.
чипка̄р до этого гиркуиша̄тын.	волки до этого ходили.
кислокандӯ индена дан= ахиси бисё̄ф та̄дӯ ǝ-.	в кислокане живя, женатый (=с женой) был там.
эниндуйӣ бэлэдеңкӣф.	матери помогала.
амӈаван аӈакэллу, чтоб нуӈан юлдо̄н, тар чаӈит юлдо̄н абдундукки.	вход  откройте, чтобы он вышел, чтобы медведь вышел из своей берлоги».
умукон орондӯ киӈгило̄н бисо.	у одного оленя колокольчик был.
дылвэв поцарапал	голову мне поцарапал.
таргит эмэчол бичо̄тын.	оттуда они приехали.
ēкунда асин, дептылэтын асир.	ничего нет, еды нет.
«тар-кэ ичэвуллэн дылин».	«вот его голова показалась».
«би эhико̄н эма̄мия танчэлдем это, нуӈарватын.	«я сейчас буду их нарочно тянуть.
о̄н туги ңэнэвуфкӣ-тэ, проводник бинэ?	как так отвозит, будучи проводником?"
****	****
энинңэхэ гундэрэн.	мать покойная говорит:
нэкурви, ӣлэн ахал, эдӯ бидерэ.	младшие сестры три здесь живут.
долболтономок эмэӈнэм».	только к вечеру прихожу».
нулгӣктэфкӣл.	кочуют.
хактэ инектэлко̄тчэрэ мортын момоӈил.	смеются сами над собой.
ӈинакир гогодерэ.	собаки лают.
ирэн умуко̄н дюкчала̄.	вошел в один чум.
урэгэ̄ндӯ, калтырдӯ, тадӯ.	на обрыве, там, на склоне.
дюмадук юсо-до̄, тэпкэтчо.	из чума вышла и покричала.
нуңартын дежуридепкӣл, ну а тырга мы, бӯ һавалдяңнэрэвун, нӣ-гэ ё̅!	они дежурят, ну а днем мы, мы работаем, кто же!
hукулэ̄девкӣ.	лежит.
тадук уставатын-тэ манаран.	потом всех прикончил.
aӈи, поповы были, тоже эвеӈкӣл	эти, поповы были, тоже эвенки.
уже кали осалаи, нуӈан хавалилдан зверофермадӯ.	уже став большим, он стал работать на звероферме.
ē ну эртыкӣ же уӈунтыкӣ бинэ, биркэ наверное.	да, ну туда же, в сторону того будучи, были, наверное.
палакинэдӯвэр балдым.	я выросла в плахине.
эрдэло̄н hурупсёл тар бэевэ.	совсем унесли того человека.
аhаткан одан.	он стал девочкой.
"самолет хорошо, оленей хорошо, а олени лучше!"	"самолет хорошо, оленей хорошо, а олени лучше!"
устэ= бэйэвэ ха̄рэн, бэйэ.	человека знает .
огдоко̄соко̄нви, карияса̄нми лукча-да̄, амардукин туксадянэ.	он снял свою парку с шерстью, свою замшевую парку и бежит сзади.
тāдук ирэмӣдечōвун тāлӣ второй стāдоду, первый стāдоду.	оттуда туда в гости ездили во второе стадо, в первое стадо.
ӈэлифсипчу-кэмэ, эрупчу эвӣвун-до̄ бими, этэкэл, этэкэл!»	очень страшно, перестань, перестань, потому что это плохая игрушка!»
бэйэл орорвэ га̄ттэ.	люди оленей разобрали.
умно̄ hэлэ бэе умуко̄н бултадеся, гиркудяса, сипка̄мӣдеса бисё.	вот однажды один человек охотился, ходил, охотился на соболей.
гусё тар бэе.	сказал тот человек.
бэел-кэ нюӈун бисо̄тын, буко̄куттэ.	мужчин шесть человек было, поумирали.
вот мом эдӯ индем, поселкадӯ хантайское озеро.	сама я живу здесь, в поселке хантайское озеро.
тарит горово̄ инэн.	оттого долго жила.
****	****
эхӣ всё, ни поселкал даже нету.	сейчас все, ни поселков даже нету.
доӈотоми, эдӯ бисё бимчэл.	если бы замерзли, были бы тут.
акӣм уже хар хагды одан.	брат уже взрослый стал.
где-то, наверное, демӈэнэн тадӯ биркэ, ēкун-ка.	где-то, наверное, там его объедки, что-то .
этыркэ̄м, василий иванович, сурурэн, гэннэ̄стэн орорди саво̄далвэ, гэннэ̄рэн, эмэврэн.	муж мой, василий иванович, поехал, чтобы на оленях привезти вещи, забрал, привез.
учиттяӈкӣф учамидӯ.	учился я в учами.
часовня.	часовня.
потом ча̄скӣ сурурэв hэрэкэт, hэрэкэт hоктэт сурурэв-кэ эсӣлэ̄.	потом в сторону поехали, другой тропой поехали тогда.
таймурава да̄грав.	через р. таймуру переправились.
тадук hэлэ нуӈан, нуӈанман умканэм, нян гуканэм, тадук ганатма̄силча.	потом это, он его... стал стреляться.
амин авипдяфкӣ — энӣңэhи аминин.	отец "дорогу делал"  , отец покойной матери.
мучудерактын эрэ, удядӯтын иhича-кэ бичо.	когда они возвращались, он на дороге их догнал.
****	****
и бу потапчика̄дулӣ тоже эвэски.	и мы через потапчик тоже сюда.
кэримко̄рвэ пэктирудэңкӣн утэ̄лэ̄.	белочек стреляла раньше.
****	****
ну нуӈан тыкулдэн и давай тукса̄hинэн	он рассердился и давай бежать.
тыма̄тнэ элэвон ора.	утром все сделали.
би этэм hинди гиркӣтэ̄деми.	я не буду с тобой дружить.
эва?	что? 
hулукундӯф бу нулгиктэдеӈкӣвун эрэ амбардулӣ, кулумбēлӣ.	когда я была маленькая, мы аргишили на этом самом, по рыботочке амбар, вдоль речки кулюмбе .
дудинкала̄ норильскадук валектӯ.	в дудинку из норильска на валек.
****	****
мӯдӯ эр-кэ, аӈэ, иргэктэлдук тэгэтчэчо̄тын.	в воде сидят от паутов.
буруден который — опять горы опкӣл.	которая упадет — опять горы появляются.
гуннэ, думайча тар бэе.	подумал тот человек.
орорвун hуто̄лэ кэтэ бисо̄тин.	оленей у нас раньше много было.
умуко̄нмэ ва̄рэв.	одного мы убили.
тадук нян улуму..., улумиӈнэрэв, улу... улумоӈнэрэв.	потом опять уезжаем белковать.
«би уӈтувунэ окта эр ирэксэдук.	«я сделаю бубен из этой шкуры.
кэтэво оролорвэ буңкитын, оролоңмэ.	много оленеводам мы давали, оленеводу.
уйдэн аят.	хорошенько привязал.
мо̄тӣ hукулэ̄деко̄куттэн hойдӯ.	лось разлеживается в кустах.
амаскӣ тэпкэдяна тукса̄дям.	назад я побежала, крича.
****	****
тар ирэксеӈми аӈдан-да̄, оран тар уӈтувунэ, эhӣ тар hēктака̄рдук мо̄ян оканэм.	сделав из тальника каркас, он шкуру это самое — и вот он сделал  бубен.
инэктэңкӣтын.	смеялись они.
энинмэс hуруврэн.	твою мать увел.
ну продайдяӈкӣн здавай зда̄ниӈкӣн магазиндӯда̄ тар, как трудодни.	ну, продавала, сдавала в магазин-то, как трудодни.
ēдук оран мугдэко̄н?»	откуда взялся пень?»
тадук ама̄ка̄дукпи hаӈӯкталча:	потом стал спрашивать у дедушки:
орорво айичимни».	оленей лечащей, врачом оленей».
мо̄ла̄деңкӣф.	дрова готовила.
уӈтувунми гаканэм, уӈтувунми луhу дуктэденэ, ойитын.	взяв бубен, в бубен все время колотя наверху.
но всё равно этэ̄м омӈорэ.	но все равно не забуду.
потом турпа̄кадӯ, школьный мыс.	потом на турпаке (русское название: школьный мыс), школьный мыс.
ачин бичо̄н эдӯ мугдэко̄н.	не было пня.
ирэмо̄hисён-до hутэлдэло̄ӣ.	поехала в гости к детям.
кэрэмӣно̄счо̄вун севернай таймурала̄.	поехали охотиться на реку северная таймура.
вадендэ.	ты убьешь .
говорит нуӈан.	говорит он.
тар бу эмэрэпда̄, би нянчитчэлим.	когда мы с вами приехали, я стала нянчить .
раньше, эвэдыт, да? эвэдыт.	раньше... по-
эвенкийски, да? по-эвенкийски.
урӣнэллэв.	остановились.
"василий!	"василий!
hо̄дӯ городӯ уто̄лэ умуко̄н бэе, бултадена, эмукин гиркудяна, эрдэло̄н ēкун-мал ямадӯн бурусо.	давным-давно один человек, когда охотился, когда ходил один, упал совсем в какую-то яму.
бултарэв.	мы добыли.
который дундэ тала эмэнмурэн, угӣло̄ — о̄hӣктака̄рди одан.	земля, которая осталась там, наверху — стала звездочками.
гусён.	сказал.
вот hагдандулайӣ улдитчэңкӣн.	до старости шила.
эвандэ̄ эчэ̄в эракадэ̄.	ничего я не это самое .
****	****
потому что эчэ hуктыллэ мунтыкӣ.	потому что не побежал к нам.
но энин... энинмун умукин мунэ аӈэдеча̄н и...	но наша мама одна нас это...
кан нуңан о̄фкандиңкӣн эр навехи= навехилвэ.	именно он велел делать навесы.
дынӈӣлэ̄гичо, тэпкэденэ, нуӈардула̄тын.	побежал, ревя, к ним.
эхи хунмиктэл навалом.	сейчас мошки навалом.
в упор пэктыро̄чо̄н.	в упор он выстрелил.
микчанэм угучактыкӣ.	спрыгнул к оленю 
«би hинэ но̄дадиӈа̄в эрэгэрит.	«я тебя совсем брошу.
ӣ, обед ӈэнэ̄чэ̄лэн, нулгистэв, нулгистэв вперед.	и, когда обед прошел, начинали аргишить, начинали аргишить вперед.
би ичэдем: оӈоктон багдамача, белый полоса, багдама.	я вижу: у него нос побелел, белая полоса.
ни нэкунми=тэ ачин бисон=нэ.	ни  младшего не было.
амтача̄н нуӈарватын-ка.	он почуял их.
би ба̄ңнэм, "о̄н бригадир бидем?" — гуннэ.	я отказываюсь, говоря: "как буду бригадиром?"
нуӈан ӈо̄лэпко̄нэн ӈинакирва.	он испугал собак.
ико̄лэптыдӣ... угучактӯ тэгэтчэнэ, ико̄денэ, ӈэнэдевкӣ угучак, и до̄лдӣм:	я ехал, сидя на на верховом олене, и пел, и услышал:
умнэко̄ртэ экун эмэрэн мутпэ эвэдыт алагудае.	редко кто пришел нас по-эвенкийски научить.
энӣнми пака индечо̄н дюдӯ эдӯ тожэ ербэкэдӯ энӣнунми улгучэма̄тчэӈкӣв.	мама пока жила, дома здесь в ербогачене с мамой разговаривала .
что-то ēва-вал ӈалэлдиви минэ мо̄ндуло̄и...	что-то почему-то руками меня к себе...
вот эхӣ эхая асин одам вот теперь.	вот сейчас без глаза стала, теперь 
«ну, наверное, биркэ.	«ну, наверное».
****	****
граматэв а̄син, все равно улгусёниңнэм: "тугу, тугу, тугэ айисӣңнэм орорво, тугу, тугу оңнокорвэ балдивуңнэрэв," — гунденэ.	грамоты у меня нет, все равно рассказываю, говоря: "так, так, так лечу оленей их. так, так телят выращиваю."
экун-ка участок хогдыңа.	этот, участок большой.
тар тоговэр hиӈкэрӣдерӣван гундевкӣл бисёл.	говорили, что огонь у них трещит.
чисто бичо̄н экологическаил.	чисто экологический был.
hавалдерэ.	работают.
энӯпчу тукко̄нди эрэхиндем энӯло̄н до̄ла̄.	больно, вот так начинаю делать, больно внутри.
тадук мусюми.	потом вернулся.
ēкун-да асин.	ничего нет.
потом, вертолет дэгилчалан, hурум — нэ̄ку, нэ̄ку дагин hукулэ̄дирэн.	потом, когда улетел вертолет, я пошел — рядом с лабазом, лабазом   лежит.
вамулча ӈинакинма hэвэкӣ.	бог рассердился на собаку .
тэгэминун ниhӯнэ̄hинэм-нун дядянунми.	назавтра поехал отвозить тушу с дядей.
чипка̄рвэ ва̄деча̄в, мо̄ты̄лва.	соболей убивал, лосей.
нуӈартын, чулугдыл, hэгдымэмэл бичэ̄тын.	они, чулугды, были огромными.
да.	да?
олгӣса-да̄, тадук hэлэ тариӈми тадӯ локосо, аямамат олгодо̄н.	высушил и потом-то ее повесил там, чтобы хорошо высохла.
хокориттэ-да, малый стадо, манаврэн орон.	потеряли, малое стадо, олень закончился.
ēкура никэдеӈол ода̄вэр ӈо̄лда̄н тар сипка̄нӈис.	что  делать ?
би hуюкуко̄н бичо̄в тогда.	я маленькая была тогда.
би нуӈанман гунил... орӣл....	я ему стала ...
эдӯ а̄рӣрэн, эду-кэ, "пастукилкэл!" — гуннэ.	сюда позвал, сюда, говоря: "пастуши!"
экэлду эмэрэ эрэгэрит!» — гунденэ.	не приходите никогда!» — говорит.
hурувсо̄тын, эр илкэ̄нденэл hурурэ.	увели, делая зарубки, пошли.
ну тогда этот варак гундерэн:	тогда враг говорит:
ēкун-мал-та о̄дан.	что-то случилось.
улгурдям, он hаргилтыки шуруӈнэрэв эдук.	расскажу, как в лес уходим отсюда.
мэндеркаӈаха бичо̄н.	покойный хромой  был.
аминтын эделин эмэрэ, тариӈилби дяяран.	пока их отец не пришел, он их спрятал.
дю̅какāндивэр бичōвун.	у нас был маденький чумик.
миндула̄ ичэтчэрэн.	смотрит на меня.
турукокиттула̄ тас= тассяңа̄с.	на соль (=на место, где соль) пригонишь.
эр-кэ оронэ асин эвэнки этон уто̄лэпти эмты инэ.	ведь безоленный эвенк не смог раньше жить.
зоотехник о̄ми ороды хавалим дипломми упкатпа-на.	зоотехником оленным став, я отработала целиком  свой диплом.
****	****
би-кэ он нуӈардӯтын туратчэм эвэдыт — хорокил.	я-то как им скажу по-эвенкийски —  глухари .
поэтому эсӣко̄тко̄н эӈэнӣ би эӈнэм аяврэ экур-вэл таргачира.	и сейчас я совсем не люблю что-либо подобное .
бэел ико̄лдэ.	мужчины запели.
и это вот нуӈан — уже забыла, как «по плечи» — уже начал проваливаться этот враг.	и это вот он — уже забыла, как «по плечи» — уже начал проваливаться этот враг.
таравэр койивко̄тнэл, орорвэ хи= бӯсилдэ бэйэлдӯ.	заблуждались, когда оленей людям раздавать стали.
тар валектула̄ дювупкӣл бичол уӈуно.	в тот валек возили это самое.
эмэрэ.	пришли они.
бӣ дю̅дӯви, то hилкидяңнам депдōе вари… һуладеңнэм, ōһаңкāрви һӯчудеңнэм, убирайдеңнэм.	я дома, то стираю,  еду варю, камысы скоблю, убираю.
«би-кэ биhэм hэвэкӣ».	«я-то бог».
этыркэ̅н һаңкэлэе ōдяпкӣ. ну вот и всё	муж санки делает. ну вот и всё
«эр-кэ, уркэвэ аӈалдендэ̄,	«это самое, вдруг двери откроет,
зооветтехникуммэ манам.	зооветехникум закончила.
вот так бичо̄в.	вот так я жила.
«нулгӣско̄т эрко̄рди, вот нулгиско̄т эрко̄рди».	«давайте поедем на вот этих , на вот этих».
****	****
эсӣко̄тко̄н умуко̄н внукив... армияла̄ гара.	сейчас один мой внук... в армию забрали.
****	****
умно̄ амӣӈаhав hурурэн посёлоктула̄.	один раз отец покойный поехал в поселок.
тадук hэлэ, тар hуруса̄лан, hа̄рги тадӯ hоролдесо дагӣ.	а потом, когда он ушел, черт крутился там рядом.
энӣ дюдӯвэр галянун эмонмопкӣ.	мать дома с галей остается.
мēвӯича бичо нуӈарватын.	он был на них очень рассержен.
ой, hуктыллэн тоже.	ой, побежала тоже.
тадӯ бичэтын, кэргэнтын hэгдил бичэтын.	там были семьи их, большие были.
деревнядӯ экун-да̄ ачин: яблокэл, экур-да̄ ачир.	в деревне ничего: ни яблок, ничего не было.
энёкэв девяностых годах ачин о̄ча̄н.	бабушки в девяностых годах не стало.
вот аят индям, в общем.	вот я хорошо живу, в общем.
эмэрэн дюла̄и.	пришел домой.
тар ама̄ка̄н гундерэн...	дедушка сказал...
потому что нāңмактадӯ нуңартын век лежат, боятся комаров, в лес не hодят, редко ночью только, ой, долбо только, долбо ңэнэпкӣл.	потому что на комарах они век лежат, боятся комаров, в лес не ходят, редко ночью только, ой, ночью ходят
«эдук-дэ̄ век буссэлдерэс.	«теперь вы всегда будете болеть.
****	****
и ӈинакир ēкун-мал гогодерэ тадӯ, уллэдӯ.	и собаки кого-то лают там, на мясе.
аӈэ, калакача̄н бичо̄н мунӈӣ, таз.	это, котелок у нас был, таз.
ну и все, ну и это, я говорю, это, ходим на лыжах.	ну и все, ну и это, я говорю, это, ходим на лыжах.
бэюнмэ нян этон тук пэктыро̄рэ подряд.	дикого оленя опять же он так не станет стрелять подряд.
hутэлтин кэтэмэмэ бисо̄тин.	детей у них было много.
би гундем:	я думаю:
hогдоко̄ртын.	хвостики у них.
****	****
умуко̄н hутэн.	у него один ребенок.
тар куӈакандӯи букокутча.	он умер ребенком.
мо̄нин хавалилдан.	сам начал работать.
би гунилим: «экэл орэрэ, тадӯ аӈил, аӈил ӈо̄нимил бӯнӣдерэ», — гунилим.	я стала говорить: «не кричи, там эти длинные воют», — стала говорить.
уже hактыра̄ллан.	уже стало темнеть.
«буран» ӯдялӣн некэрэвун внизтики 	по следу «бурана» мы поехали вниз. 
мундука̄рэ эмэвувкӣ.	зайцев приносит.
аӈадяка̄рин-тэ элэтын тумнипчал.	сироты-то его все оплеванные.
бу гунно̄рэв.	мы говорили, наверное:
тар hутэлнунин бидевкӣ тар бэе.	с его детьми этот человек.
тар дюла̄вэр ирэктын, илдевкӣ.	когда они заходят домой, он заходит.
hулукундӯф ӈэнэктэсо̄вун потаптула̄ орорди.	когда я была маленькая, мы ездили в потапово на оленях.
амӣ охотник бичо̄н.	отец был охотником.
****	****
тадӯ же напугал оронмо.	там же напугал оленя.
ēкунма орорди эмэрэн.	кто-то на оленях приехал.
ама тар, как его....	дедушка тот, как его...
умуко̄н гулэвун только.	один дом только.
ну умукин мунэ аӈидеча̄н .	ну, она нас воспитывала .
аӈи лучал коколдолтын же.	это самое, рукавицы русских же.
тар ӈинакинма гиркӣтэ̄десё.	ту собаку другом считал.
аӈил, орор ӈэнэдерэ.	эти, олени идут.
потом чипка̄нӈис тар мунуранда̄.	потом эта твоя утка протухла.
нуӈартын ӈэнэдепкӣл чулук-чулук-чулук.	они ходили: чулук-чулук-чулук.
би-кэ хагдисаңэхийи-нэ, э̄кун о̄дям?	старый стал, что буду делать ?
ичэттэн нуӈарватын:	посмотрел на них:
hавалкира̄, hавалмнӣтын оран.	работящий... стал у них работником.
но уӈунбэлэ, адэлинае хуруврэн.	но он эту самую, аделину свою повез.
тадук эр турула̄ эмэвуңкӣтын гурушшикил.	потом, это, в туру привозили грузчики.
—экун тавэр? — гундерэн.	—кто там? — говорит, —
туксама бичо̄в.	я быстро бегала (=хорошей бегуньей была).
hукэвэ бурэ hэгдыко̄кун.	топор дали огромный.
аӈила̄ би дагама̄м, моhала̄.	к этому самому я подъехала, к лесу.
стараявэ метрикава бакачавун а... моhадӯ.	cтарую метрику нашли в лесу.
то̄лӣ ая бич... ая то̄лӣ.	тогда хорошо , тогда...
hэлэ маӈӣ аhӣ кэлтэр hуктыллэн, иланди маӈӣл бэелди.	вот медведица в другую сторону побежала с тремя медведями-самцами.
****	****
мирэним.	вышла замуж.
тар совhозтӯ би hавалилча̄в.	в этом совхозе я стал работать.
тар бэевэ исесо тар дэги-киӈгит, киӈгит тарэ.	того человека увидел эта птица кингит, "звенящий".
в очках ходил все время, у него специальные такие очки.	в очках ходил все время, у него специальные такие очки.
«hэлэ, hурурэв, hурурэв, ӈэлифсиёй, ӈэлифси.	«вот, уйдем, уйдем, страшно, страшно.
тāдук стāдолāтын нулгӣрэвун.	оттуда мы в стадо аргишили.
ха̄кин, дептэл-дӯ, крупа̄-дӯ, масло-дӯ, бурдука-дӯ, эсэ хунтил-дӯ бу бэлэңкӣвун оролон= оролордӯ демӯдерӣлдӯ, мэнңӣвэр хэлэрэкин э̄вэр.	сахар, еда, крупа, масло, мука, еще другие , мы помогли, оленеводы, оленеводам голодающим, если у нас останется что-то.
"хинңӣ опытис хэгди.	"у тебя опыт большой.
дяндук тунӈа анӈанӣв бисо̄н тадӯ.	пятнадцать лет мне было.
нуӈанман-мок-ко̄н эвкӣл эйдэрэ, даран гиркудярӣва.	совершенно не замечают его, когда он ходит рядом.
тыма̄тнэ ала̄ттэн тырганӣвэ.	наутро ждала целый день
упкачин аӈэ, гарь ачин, эчэ, дегдэ̄ эрэ бирэ, если бирэкин тар мугдэко̄н.	всё, гари не было, если бы это был пень .
****	****
эдӯ hа̄рги гиркудявкӣ дагӣ.	здесь черт ходит рядом.
тоже илмакта бисо̄ф.	я тоже молодая была.
еще эпкӣт бичо̄н.	еще нельзя было.
тар оӈкоко̄кун биӈкин, гунипкӣ то̄лӣ.	говорят, там было было много ягеля.
фронтадук исё.	с фронта еще.
но и нюӈун внучатылви биhэ.	ну и шестеро внучат у меня есть.
умукон кэргэндӯ орортын hердӯтын hунңту экуртын hамэлкӣтын.	в одной семье на ушах оленей одни  эти самые, отметка.
чаӈит тар, чаӈитпа тарэ аӈива̄т, чокна̄га̄т».	давай это самое, пойдем убьем того медведя ».
ганатма̄тчэвкӣл.	долго стрелялись.
тоже тумнипча элэн.	тоже весь оплеванный.
лусадыт нуӈартын эрэ тарэ миндулӣ яӈурэ.	по-русски они со мной не говорят.
индемчэл.	жили бы.
«hэлэ этэетчэкэл бэеӈилбэв!	«давай, сторожи моих людей!
эңкӣв гороё хавалда.	не мог долго работать (=обычно долго не работал).
уже дяндук дяпкуси-вэл о̄рка нуӈан анӈанӣ-сэ.	уже стал он, наверное, где-то восемнадцати лет.
ганалчилтыкӣ гусо:	стрелкам сказал :
hактыра̄лча уже.	темнеть уже стало.
ну, умукэ̄н hалгачичил.	ну, одноногие.
ичэм абачӣва.	увидел медведя.
"аӈя окэл!" — гунэн, —	"это самое сделай!" — она сказала.
hактирила̄ hурувкӣ.	она ходила в темноту.
ило̄до̄ пока эдо̄и hурурэ некэдям, пенсионерка.	никуда уезжать не собираюсь, пенсионерка.
дюктэдӯтын угранда̄ тарэ.	он сел на них двоих.
иhэлдӯ hо̄ бивкӣ игин.	на камнях был сильный шум.
я би гуним: «кэ, эсӣлэ̄, каманя дявакат аӈилвар, ӯчакилвэ!	я сказала: «давайте сейчас скорей поймаем этих, учаков!
тарэ вместодӯн hавалчав-да тэр исполняющим директором.	вместо него я и работал тем исполняющим директором.
«эдук этэндэ.	«отсюда ты уйдешь.
мом, а мом орорэ эхиндевадем и хоктэва хинчэм ӈэнэм.	сама я оленей ??? и поскачу???
би улдэӈилван орорди дёвудедем.	я перевожу мясо, принадлежащее ему, на оленях.
hавал иду-дэ эчэв hавалдяра.	нигде не работаю.
куңакандуйӣ би туксэктада̄йи экэңкӣф, эвидэйӣ аhаткарнун.	в детстве я побегать хотела, поиграть с девочками.
ило̄ больше одерэ?	куда еще денутся?
арама мучум таргит: буссэдечов.	я еле вернулся оттуда: я болел.
совхозтӯ сдаваӈкӣн.	в совхоз сдавал.
потом бакаран умукон кэргэнма, хутэя асир.	потом нашел одну семью, бездетную.
тарилди долбонӣ тирганӣ гурусӣпкӣл бурдукалво уставан-тэ.	с ними ночь, день грузили муку, все подряд.
умно̄ hурусо бэетко̄н тарэ.	один раз пошел этот мальчик.
аӈилвэ, багдакэ̄лвэ ва̄дякилвэр тарэ дебдерэ.	диких оленей, убив, едят.
тадук би до̄лдым:	потом я услышала:
чипка̄рвэ тоже».	птиц тоже».
тунӈа анӈанӣв минӈӣв асин бисо̄н.	пяти лет мне не было.
и то̄лӣ до̄лдӣллэв, до̄лдӣрэв.	тогда мы услышали, услышали.
ӈэнэдесо.	шел.
сипканмэ, дэңкэва гогодяран.	соболя, соболя лает.
но потом, гундерэн, ӈэ̄лэтчэпкӣл юда̄вэр тулискӣ.	но потом, говорит, боятся выходить на улицу.
ну тāдук ōкӣлдэвэ, там илалдаво всего нулгӣчōвун даркиндуваин.	ну оттуда сколько дней, там три дня всего аргишили по хорошему насту.
гунэ-кэ: эhикон чиктил кэтэмэмэ̄ онёто̄лис.	говорила, что сейчас бисера очень много, только бы заниматься
тадук нуӈан ичэрэн hэгдыко̄рва аӈи... hалгарвэ.	потом он увидел большие ноги {т. е. следы}.
ехэлдук, чириндалдук, байкисилдук хирулвэ меняйиңкӣвун.	из ессея, из чиринды, из байкита меняли быков.
никольское-кэ тар вообще нету тоже.	никольское-то, того вообще нету тоже.
амӣ дальше хуру=, ча̄скӣ хуруден, мо̄хавэ ча̄скӣ.	отец дальше поедет, в лес дальше.
потом уже илитын тырганӣ hурурэн.	потом уже третий день пошел.
энӣӈэhэв чатыпка̄лдэн-да̄ и улгусо̄лдэн:	мать покойная чаем напоила и рассказала:
экэл дуктэрэ!»	не бей!»
«уркэва аӈасилдендэ̄,	«двери начнет открывать,
тадӯ бэюр тогда угдуhичэл бичэ̄тын.	туда дикие олени тогда залезли.
ну, мэнңилдук дуннэлдук гаңкӣтын тар эвэнкил, антил эрупчут индечатын.	ну, со своих земель брали те эвенки, которые плохо жили.
бу= оролорвун дефкиттыкӣвун.	оленеводам нашим наши продукты  .
ну, только дюрвэ хами нимӈака̄р.	ну, только две знаю сказки.
нуӈартын ӈэ̄ллэ.	они испугались.
жерди, аӈэ, жэрдилвэ, тар мо̄лвэ но̄ттэ, где у него амӈан.	жерди, палки разложили, где у него вход.
би гуним:	я подумала:
до̄лдырэн: чулугды  эмэдерэ.	услышал: чулугды приходят.
туг оронми иргидефкӣ-то̄, оронми иргивдо̄н, короппан менять надо, хирулвэ меняттеңа̄т.	так оленя воспитывают, чтобы оленя воспитывать, важенок менять надо, быков менять будем.
и ичэрэв тадӯ: аминмун орорин ӯчакилин тэгэтчэрэ.	и увидели там: олени, учаки нашего отца лежат .
куӈакан тарин луhу, балдыдяна, hаӈӯктавкӣ:	ребенок этот все время, пока рос, спрашивал:
гиркундякал идӯ-дэ̄! — гусе, —	гуляй повсюду! — сказал, —
та̄ла̄, наверное, биркэ.	там , наверное, был.
умуко̄нмэ маӈӣва аhадерэ, нюӈун бинэл, аhӣва маӈӣва.	одного медведя гонят вшестером, медведицу.
мoртын исэттэ хоктэвэр.	сами смотрели дорогу свою.
тадук директориф то̄лӣ бисён алексей дмитриевич елдогир, гиркӣв минӈӣ.	потом, директором тогда был алексей дмитриевич елдыгир, мой друг.
багдакэлэ ичэтнэ̄hинэм.	поехал диких смотреть.
hутэлин тадӯ бидевкӣл.	его дети там были.
надалдавэ нулгӣчōвун кун... тāлā.	семь дней аргишили потом.
тукко̄р оёлинэ эр арамака̄н некэлиӈнэм.	вот так потихоньку я начинаю обычно делать, почесывая.
аӈивэ, мо̄вэ тарэ би... минэ но̄да̄рэн.	эту, палку, меня швырнул.
но всё равно упкат уже почти лучадыт упкат hэӈкэтчэпкӣл.	но все равно уже все почти по-русски говорят.
шура ну.	шура, да
тавартыкӣ тар истоктулӣ, тавар, истоктӯ би хинэ нянчитчича̄в аха.	в ту сторону, к тому, истоку, там, на истоке я тебя нянчила, ага.
тари тар тāдӯ дю̅таравун, инэрэвун.	вот там пожили в чуме, побыли.
«эбэ̄й, бэе, экэл ӈэлифсе бидегин.	«ах, человек, не надо, страшно, пусть будет.
«эла̄ нуӈарватын но̄дям?»	«куда я их дену?»
«э̄, ēкунинда̄-кэм эсё ӈэливсипчу бирэ!»	«э, никого же страшного нет!»
нуӈан гунэн.	он говорит: 
hэлэ эвӣвунэвэр одям».	вот игрушку сделаю».
минӈӣ амӣм бисо̄н гэрбӣн дада, эвэды гэрбӣн дада.	моего отца звали дада , эвенкийское имя дада.
hаялэ та̄ла̄ ӈинакир, гошаядӯ.	нет там собак, у гоши.
бры= брызгэвэттерэ.	брызгают они.
а ӈинакин тар со̄лилча, hа̄ргиткӣ гуннэ:	а собака стала сплетничать, говоря черту:
гусё тар hутэлвон.	сказал он детям.
би нян туксасинэм карабиндула̄и.	я опять побежал к карабину.
илан тырганӣл ӈэнэчалатын, эмэрэн.	когда прошло три дня, пришла.
а то хувэр рыбакил бичол эрэ амӣӈахастэ̄.	а то вы были рыбаки, этот, отец твой покойный.
дяпкӣдӯи hурусо̄в, дяпкун анӈанӣдӯ.	на восьмом (году) пошел, в восемь лет.
потом потаптук нуӈарнунтын эмэхилдэрэв.	потом из потапова с ними стали ехать .
бумулифкӣл орор, хиңненэ.	умирающие олени, жалко очень
гунэ.	они сказали:
дуннэла̄ бурум.	я упала на землю.
дюр hутэси, этырко̄си, hавалдяран тадӯ.	с двумя детьми, замужняя, работает она там.
hо̄ксэ ӈэнэдерэн.	кровь идет.
мэнмактэл иргэктэл орорво-кэ кикчафкӣл.	комары, пауты оленей-то кусают.
мурӯкэ̄дявкӣ амутва, мурӯкэ̄дявкӣ.	кружил, кружил вокруг озера.
а би хэлэ амаскӣ мучувохиндем хэлэ улдэӈилван, улдэлво.	а я вот назад отвожу  мясо, принадлежащее ему, мясо.
ну что еще, потом долболтоно депдōтын ōңнам, чтоб долбо дебдедōтын, һутэлдуйӣ	ну что еще, потом вечером поесть делаю, чтобы ночью поели, детям.
их никак, эчэв, албарав дявадями.	так их никак не, не смогли мы поймать.
мом эло̄ hэлэ эмэсо̄в.	сам сюда вот приехал.
ну, улгучо̄ндем.	ну, расскажу.
тадук элэ, тар эконэм на̄вканэ, ама̄ка̄н лукӣлвэн hэлэ пēрēм о̄лча аямамалэ.	потом вот, не попав, дедушка стал делать настоящие стрелы, очень хорошие.
****	****
эдук этэм hинди гиркӣта̄рэ».	другом тебя больше не буду считать».
этэйэтчэңкӣн амиңэhэ.	покойный отец сторожил.
кэӈгило̄ртын кэӈгило̄рин до̄лдым.	их колокольчики, его колокольчики услышала.
эмэрэ-дэ̄ удялӣн.	приехали по следу.
****	****
потом дэлкэндӯи, эевэл гада̄и, туктысо бисё.	потом на лабаз что-то взять залез.
тогда варак гунденэ:	тогда враг говорит:
hутэлви девдо̄тын, тар дюгудевкӣ бисё тар киӈгит.	тот кингит приносил детям поесть.
а орор тоже ӈэ̄лэлчэ̄л бипкӣл.	олени тоже испуганные были.
толгокӣдуктэпи юм, амӣ нёгую уитчэнман пока.	я вышла из своих санок, пока отец привязывал передового оленя.
пустырэ нуӈанман.	отпустили его.
илда.	встали.
место ая тоже.	место хорошее тоже.
индисо̄тин дуктэ.	жили они вдвоем.
ама̄ка̄тка̄нмэ hуюкуко̄нмэ дявудеча̄тын.	они поймали маленького медвежонка.
эрэ ганалчил эмэсолдо̄.	вот стрелки пришли.
эдын hукугичо нуӈаригитын.	ветер стал отворачиваться от них.
ēкур илкэ̄ндекисилтын?»	чьи это зарубки?»
ахал надан толгокӣтын бифкӣл, бэйэлңӣл дяндук дюрэ, дяндук илан бинэл.	у женщин семь саней грузовых было, у мужчин двенадцать, тринадцать было.
эя-вэл, ēкуӈан биноро? — гунденэ, никосо. —	кто, откуда могут быть? — вот он говорит. —
чокна̄стэв чаӈиттула̄.	пошли убивать к медведю.
эртыкӣ амутка̄н хэгдыӈэ ичэбдепкӣ.	туда озеро большое виднеется.
hуливун о̄дан.	все стало.
тар бэе яӈу яӈуракин, тоготын hиӈкэвкӣ бисё... hиӈкэрӣдевкӣ.	когда тот человек говорит, у них трещит огонь.
тунӈа метрит тариӈитын буручо бичо.	в пяти метрах он упал.
тадук hама̄н тэгэрэн.	потом шаман сел.
сура бичо̄н.	шура была.
хорошо...	хорошо...
илкэ̄ндулӣтын hурукэл».	иди по их зарубкам».
****	****
хоӈкэтчэнтэӈап всех ??.	???
бэе бэе гиркӣн одяӈа̄с.	будешь другом человека.
ойин hарикталча.	над ним начал парить.
«мо̄ла, мо̄ла !»	«дров, дров !»
то̄лӣ эдӯ бисён совhоз.	тогда здесь был совхоз.
«hатанава эр, — гусё, — элэвэл биӈнэдерэ», — гунденэ.	«черта этого, — говорит, — какие-то бывают».
би, куңакан то̄лӣ, аминми луху бэлэдеңкӣф.	я, ребенок тогда, отцу своему всегда помогал.
дядяв ёкэллэн:	дядя закричал:
****	****
энинңэhэйи би аят дончадям.	мать свою покойную я хорошо помню.
так аркича̄тын эхавэв тар.	так они проткнули тот мой глаз.
этэрэв эрэгэрит эдук исевулдэ».	с этих пор никогда не станем показываться на глаза ».
хутэлин ода.	у него появились дети.
би чок... чокча̄в — баh нуӈанман.	я прицелился — бах его
тарин hэкэргэсо-до̄, амаргилдии илконэм, эрэ иконмон тугилвэр уставан каhиливкӣ.	тот рассердился и, встав на задние лапы, вот так всю грудь ему порвал.
дюкчадӯвэр тэгэтчэнэл, тар депденэл, гусол:	когда они сидели у себя в чуме и ели, они сказали:
деньгилби бивук биӈкӣтын мундӯ угот.	деньги у нас всегда были.
уhо̄лчо̄н.	заболел.
аминин хирогир дмитрий, аминин  удыгир валентина трофимовна.	отец ее хирогир дмитрий, мать удыгир валентина трофимовна.
э та̄дӯ но̄рәв нуӈанман.	там мы похоронили его.
турудӯ учӣтчав.	в туре учился.
интернаттӯ только депиӈкӣвун, если что уж.	в интернате мы только ели, если что уж.
диктэлэ экурва ахактадяңкӣф улгукӣлвэ улгукӣлвэ.	за ягодой, за этим, гоняла бурундуков, бурундуков.
исетча-да̄, гундерэн:	увидев, говорит:
****	****
он о̄да?	что с ними стало?
таритпэр ӈо̄лэсилден".	вот этого она станет бояться"
постоянно грамоталва бӯӈкӣтын нуӈандӯн.	постоянно ему грамоты давали.
эмонмучо̄тын гулэлдӯ.	они остались в поселке.
бэел элэ... элэ̅тын адэлилвэр тулэпкӣл дюкэлӣ уже, дюкэлӣ, и оhотятся.	мужики все свои сети ставят по льду уже, по льду, и охотятся.
тара би дёниӈнэм.	это я вспоминаю.
"хулюлан хо̄ куңакан".	"маленький очень ребенок!
 туг никочо̄н бимчэ.	так делала бы она, если бы была.
ӈэнэдесо,	шел,
тарэ, тарилба угадяна, hурурэн эрдэло̄н тар дюлдуктын.	совсем ушел от их чумов, неся эти .
би инектэлдем.	я смеюсь.
уӈундук, аӈил дялин аӈидук, гулэлдук эмэрэ-дэ̄, исено̄ аӈила̄.	родственники из этого, из поселка приехали и поехали посмотреть.
бригадир о̄кэл!"	будь бригадиром!"
и тэгэмӣлэ̄ бидечо̄в.	и до следующего дня был.
тулискӣ ювкӣ-да̄ тар бэе:	этот человек выходит на улицу:
девулдэктын, девуделивкӣ остолдуктын.	когда они начинают есть, он начинает есть с их стола.
умукин эмэнмум би, умукин.	я один остался, один.
минӈӣ омолгӣлви, э̄, дялви товло̄хинэ, господи.	мои сыновья, ой, мои, родственники поехали по ягоду, господи.
аӈиравун, обрадовались, в общем, что, обрадовались, что орор муткӣ эмэчэл дюла̄вэр обратно.	обрадовались, это, что олени наши пришли домой обратно.
****	****
бэеко̄кун исё дюла̄, тар дюла̄.	начальник зашел в чум, в тот чум.
э ӈэлэллэ.	о, испугались.
гēвран, токтоhинэн оӈоктолӣн котот.	он повторил, ударил по носу пальмой.
****	****
****	****
ну, дыгилрэвэ hавалиӈнэм, ну, дюлэшки, дыгилрэвэ амашки.	ну, четыре дня хожу, ну, вперед, четыре дня назад.
туг-до̄ но̄дэ дюла̄и иhим.	так-то хорошо доехала домой.
би гуним:	я подумала:
эпкӣ это каhиргарэ — ну и ладно — этыргарэ, то есть.	не ломается, то есть не рвется.
виборил бюллетэрвэ ңэнэвуңкивун.	на выборы мы бюллетени привозили.
и окин энинми мирэчэн, окин панкагирил мирэчэтын hукачарилдӯ, hукачарил гуниңкӣтын:	и когда моя мать вышла замуж, когда женились панкагиры на хукочарах, то хукочары говорили:
би дюрвэ тадӯ hорокӣлвэ ва̄мэ.	я двух там глухарей убил.
уркэе эделиконми аӈарэ, бурупкӣ.	не успев открыть дверь, упал.
улдэко̄курвэ девдерэ.	мясо едят.
и тадук-дэ̄ гунипкӣ:	и потом-то говорит:
ӈо̄лэпко̄силдэ.	стали пугать.
илмакта хавалилча̄в.	молодая начала работать.
«тариӈилнум бидедеӈо̄с, —	«ты будешь с этими моими , —
амӣ, амӣнун хурурэв охотникилдула̄ аха.	отец, с отцом мы пошли к охотникам, ага.
илмактадӯи дядянунми оhотылсядича̄в.	в молодости я охотился со своим дядей.
гундерэн:	говорит:
ча̄тырэлвэ, чипка̄рвэ — элэватын бултаӈкӣн нуӈан.	песцов, соболей — всё добывал он.
эдӯ ербэкэдӯ все время эдӯ бидечэ̄в.	все время здесь жила.
до сих пор, до старости бичо̄н, ēhан не видел.	до сих пор, до старости был, глаз у него не видел.
абачӣ улурэн тыпара̄ва и тыпаллан оӈоктови, hо̄ксэ эдо̄н оёнэ.	медведь откопал грязь и стал мазать свой нос, чтобы не текла кровь.
би албаhича̄в илдями.	я не мог встать {потому что привязанные к поясу собаки побежали}.
амӣндӯф кэтэ орон бисо̄н.	у моего отца было много оленей.
эдӯ мо̄тӣмӣдичо̄в бэюрэ.	здесь охотился на диких оленей.
вспомнила.	вспомнила.
туг-до̄ эсэ на̄вканэ.	так и не попал.
тадук нуӈан гунэн:	потом он сказал:
садиктӯ хавалча̄в тоже.	я работала в детском саду тоже
«тадӯ индерэ аямамат», — гуннэ, гуннэ, hэhэнэн.	сказал: «там живут очень хорошо, — рассказал. —
тадук тукса̄hинэн аманя.	потом побежал быстрее.
би нянчисилча̄в хинэ.	я стала тебя нянчить.
ну бу сурурэв та̄ла̄.	ну мы поехали туда.
кэтэ бичэтын омолгӣл, кэтэ hунатыл бичэтын, асаткар.	много было сыновей, много дочерей было, девушек.
эрупчут инчо̄вун амаскӣ хо̄т.	плохо жили раньше
амӣм толгокӣва оран hурупдо̄и энӣнмэф дундэӈдуло̄н и эдӯ но̄до̄и.	отец санки сделал, чтобы увезти мать на ее землю и здесь похоронить.
биралду hиндатчав делилвэ, нирусярвэ, майгулвэ.	на реке рыбачу тайменя, хариусов, линков
мӯ одан тадӯ.	там появилась вода.
тар-да̄ хурувупкӣл дяндук дюлдо кило= дӣгин няматэ ки= километр хэлэкэмэт.	везли двенадцать дней четыреста километров с лишним.
ну амаскӣтэ еще орорриктэлди же гиркуӈкӣтынтэ.	ну раньше же еще на оленях только же ездили-то.
да.	да.
****	****
магазиндӯ сдайча̄вун оллолво, уллэлвэ, чипка̄рвэ.	сдали в магазин мясо, рыбу, соболей.
аӈил, бэел аӈилтын, игилтын до̄лдывра.	это, голоса людей слышны.
****	****
гил эвэн... ӣдук, ӣдук энӣ бичэ̄н — нуңартын бичэтын большой порогтук, аминтын нуңартын панкагирскайдук родтук бичэтын.	откуда откуда мать была — они были с большого порога, отец их, они из рода панкагиров были.
ну тадук нуӈан аӈидерэн...	ну потом он это...
****	****
нуӈартын акчулла дялдула̄вэр.	они стали рваться к своим товарищам.
дынӈӣлэ̄чо где-то дэрэло̄тын тадӯ.	он  бежал там им навстречу .
би, би ӯчакки дявамалчам тадук.	я своего учака быстро поймала потом.
дежуритде... дежуридепкӣл куңакар долбонӣвэ.	дежурят дети всю ночь.
пришлось ӈэнэдемит.	пришлось пешком идти.
hукитэи гаран-да̄, бӯрэн эдыткӣи.	живот свой взяла и дала мужу.
это̄н-нун эрупчут ора".	он не будет делать плохо".
hомо̄тыва умуко̄н раз ва̄мэ.	медведя один раз убил.
интэрнаттӯ так-то бидеӈкӣв.	я так-то в интернате жила.
нуӈан же гиркурэн.	он  же ходил.
эмэдеӈнэвун.	мы приходим...
омо̄ним тэгэмӣлэ̄.	оставил до следующего дня.
вот тундра, правду.	вот тундра, правду.
потом вертолетыт дэгрэвун.	потом мы вертолетом прилетели.
«бу у... утэлэ эвэнкӣлвэ... утэлэ эвэнкӣл аhӣявар гэңкӣтын hуңтулдук дуннэлдук, hуңтулдук дуннэлдук».	«мы раньше, эвенки жену брали из других земель, из других земель».
****	****
****	****
****	****
а уӈундӯ тавар валектӯ эхӣ эр валек биден, тадӯ аӈипкӣл бичол, орорвэр дявучапкӣл бичол.	а там, этот самый, в вальке,  сейчас этот валек будет, там это самое делали, оленей держали.
ещё дагама̄ва̄т».	давай еще приблизимся».
«hама hамаhалдӯ!»	«хама хамахалду!»
ичэтчэрэн:	видит:
охотникил аха ēкунди эмэркэл, не помню.	охотники, ага, на чем приехали, наверное, не помню.
бурэ нуӈандӯн та̄нда̄н.	дали ему закурить .
тут на дымокур оленям таскаем.	тут на дымокур оленям таскаем.
гулэлдӯ, там о̄кӣ — три, илалдава бичо̄вун.	в поселке, там сколько — три, три дня мы были.
эдӯ поhоронен, hукуло̄дерэн.	здесь похоронен, лежит.
****	****
раньше вон товлӣдэ̄и аявуӈкӣв прямо.	раньше вон я прямо любила собирать ягоду.
нямадивэ то̄лӣ ва̄чал.	сотни тогда убили.
****	****
тар гурустӯ гиркудярӣл.	те, кто с грузом ходили.
эмэрэв.	приехали.
туксадеда̄вэр дилдан..., дилдандяда̄вэр.	лишь бы побегать, повоображать.
хорокӣла пэктирондеңо̄с, хэлакӣла, эми гунэ хэлакӣла.	глухарей стрельнешь,  куропаток – не говоря уж о куропатках.
дядя гунэн:	дядя сказал:
и все равно, он-мэр кэденэ, попаллэн нуӈардӯтын.	и все равно как-то попался к ним.
иди, ча̄скӣ окэл, дӣскӣ, дӣскӣ амӈадук, дӣскӣ окэл.	в стороне будь, подальше, подальше от входа, подальше будь».
обыкновенная, ну.	обыкновенная, ну .
хорошая бабка бичо̄н.	хорошая бабка была.
«а сӣ экун биhиндэ?»	«а ты кто?»
нуӈан тэгэтчэчэ̄н эдынунми.	она сидела с мужем.
****	****
куӈакар hаялэ дюдӯвэр.	детей нет в чуме.
****	****
дюр hутэи эдӯдо̄ балдылдыга̄са̄н.	двоих детей она здесь с ним родила.
****	****
тэгэтчэрэн.	сидит.
если куңакан кутуси, куңакан кутуси биhикин, орорин балдылифкӣл.	если ребенок счасливый, если ребенок счастливый, олени его растут.
тоже нимӈака̄нли, ēкунли.	тоже сказка ли или что ли.
балдыча бихим.	родилась.
«бурӣкэлду минэ, — гусё. —	«уроните меня, — сказал. —
«воспитывать»-то онэ.	«воспитывать»-то как?
ну и hуктыдерэ.	ну и бегут.
продуктов мало га̄ча̄вун, продуктэлвэ.	продуктов мало взяли.
амӣндӯф hама̄н гусо:	отцу шаман сказал:
тар умукон аӈанӣ нуӈандӯн бисёв-до эло̄ отпускала̄и эмэм.	в один год я у него был, сюда (в поселок) в отпуск приехал.
аминми гэрбин бисо̄н удыгир иннокентий николаевич.	моего отца звали удыгир иннокентий николаевич.
то̄лӣ-мок тодёдёӈо̄тын, hэргӯдӯ дундэдӯ бисё, бисё», — гуннэ.	только тогда поверят: был на нижней земле», — говорит.
экспедициял тар о̄ра-да.	экспедиции это самое сделали.
муттук hэлэкэт индерэ тар hэргӯдӯ дундэдӯ.	они на этой нижней земле живут лучше нас.
ну горово̄ эсён hавалда тар казах, казаhстанилдук эмэсё.	ну, долго не работал тот казах, из казахстана приехавший.
эңкӣн та̄нэ, эңкӣн умда.	не курила, не пила.
потому что илмактал бичо̄тын сами ӈинакир.	потому что были самые молодые собаки.
и минэ гунэ:	и мне сказали:
hэвэкӣ-тэ гунэн:	бог-то сказал:
тэвла̄hидеча̄вун это дюр анӈанӣл.	мы ходили по ягоду два года .
экуннун?	с кем?
дыгиндян километр.	сорок километров.
ну, туг гундерэн:	ну, так говорит:
****	****
дулиндӯтын дюкчал исчэндэ-до̄, исетто̄и тар hэгдымомовэтын дюва-до̄.	ты дойдешь до середины чумов, чтобы увидеть этот огромный чум».
дынӈӣлэ̄hинчичо.	он побежал.
би гундем: "ӈа̄лэ".	я говорю: "рука".
и= ило-до ңэнэдеңо̄с оронди.	хоть куда доедешь оленем.
нуӈартын гуниӈкӣтын: чипича киӈгит.	они говорили: птица кингит.
hэки эрдэлон тар илитчэрэн пэhисивсё.	эта большая лиственница до  сих пор стоит расколотая.
тугэ, тугэ, та̄ла̄ мо̄лвэ но̄кэллу, та̄ла̄.	так, так, туда палки положите, туда.
дэрӯмкисадем.	отдыхаю.
а акӣм эрупчут индесо̄н тадӯ.	а мой старший брат плохо жил там.
эвкӣл-дэ̄ исерэ-hинчэ нуӈанман, эйдэрэ.	кажется, не видят его и не замечают.
hороликтэдеча бичо.	крутился.
ӈэлэвсико̄, hэгдымама, hэгдымама бичо̄н.	очень страшный, большой-большой был.
тоже мо̄тӣмӣдичо̄в hӯксинун март дулиндӯн.	тоже охотился на лыжах в середине марта.
би танчэлдем нуӈарватын».	я их вытяну».
иргисил удялватин, дянтакил удялватин иседэңо̄с.	волков следы, росомах следы увидишь.
яӈилдӯ бивкӣ, бисё, тар иhэлдӯ.	на горах бывал, был, на камнях.
потом, потом уже тылим, тылим, как только гунэ рациялӣ, hанӈӯктам.	потом, потом уже я понял, понял, как только, сказали по рации, я спросил
дян класспэ манача̄в.	десять классов закончила.
нулгӣсчэвун, нулгӣсчэвун, улумӣсчэвун, итыга̄чавун, дюи... дюдук, дюдӯвэр итыга̄лчавун, нулгӣсчэвун.	аргишили , аргишили, охотились, собирались из чума, в чуме начинали собираться, аргишили
ахал-да э̄-нэ хавалдяфкӣл.	женщины тоже это, работали.
тар бэе яӈудярӣван гундерэ: «тар того hин..., тогот hиӈкэрӣдерэн».	про то, как разговаривает этот человек, они говорит: «наш огонь трещит».
и улдэӈилван дёвулдедем.	и мясо, принадлежащее ему, стану перевозить.
«синдӯ окин аңанӣс бичэн?»	«тебе сколько лет было?»
орон эвэнкӣдӯ элэдэ hэгди бэлэго.	олень для эвенка все-таки большой помощник.
тадук hурусёлон, тарэ умукон эмэсён.	потом, когда он ушел (уволился), тот один пришел.
****	****
илан аңанӣсил бинэл, куңакар асир о̄ңкӣтин, улгучонмочилчол би... бинэл.	будучи трехлетними, начав разговаривать, дети умирали.
ага, ну боло-тэ, ӈинакирди.	ага, ну осенью-то, с собаками.
би гунилим аматкӣ: «бӯнӣдерэ, ӈэ̄лэвсы», — гунилим.	я стала говорить деду: «воют, страшно», — стала говорить.
киӈгит hутэлин-то̄ тар ёнмасилчал.	дети-то кингита очень испугались.
****	****
аха уркэватын аӈамда̄, перчаткэлвэ ичэм, туг харбалдэдерэ.	ага, их дверь я открыла и перчатки увидела, вот так ???растопыриваются???
таргит эмэчол бичо̄тын тоже.	оттуда тоже они приехали.
о̄кир би тэпкэлим-дэ̄, тадук тарил hимӯргара .	когда я крикнула, все затихло .
тугдо̄ би дюло̄скӣ hуктывуhинэм.	так-то я вперед поскакала.
прямо думала: бэее этэм бакара.	прямо думала: мужчину не найду.
аӈидӯ, долболтоно  истан.	это, вечером  доехал.
и нуӈан тэгэрэн.	и он сел.
потом, тадук би вертолетыт әла̄ әмәhинәм.	потом я на вертолете сюда прилетела.
и то еще, аӈи, утунилипкӣ до̄ла̄, наверное, утунилиргун.	и то еще это самое, чешется, наверное, внутри чешется.
эчол биhивун hарэ.	мы не знали.
нюрма̄чал.	подкрались.
амӣнӈаhав аӈилча, логӣлчо, гуннэ:	отец покойный это начал, ругаться стал, сказав:
а этырко̄м гунден:	а мой муж говорит:
би дедушка... ой, амаканун, амӣнун-hэ, би нулгӣсиним.	я  с дедушкой, с отцом аргишила.
****	****
hама̄н hама̄нилдан.	шаман начал шаманить.
****	****
тар эмча.	это бы сделали.
арчэмкачалдэ̄ мунэ — һая̅лэ: амандӣчал.	встречали нас — но не было: опоздали.
ачин, ачин.	нет, нет .
тāдук умукōндӯ дӣскӣ хуручōвун тартикӣ алик стāдолā.	оттуда вместе в лес поехали туда в стадо алика.
эвкӣл нуӈанман исерэ тариӈилин, эвкӣл эйдэрэ-дэ̄.	его не видят и не замечают.
тāлā «буран» эмэктэчэ̄ холкит.	там «буран» приезжал недавно.
ороло... оромиловун тадӯ тырэмтычо бичо.	наших оленей он давил там.
и то̄лиӈэ̄ будан учамиду.	и тотчас умер в учами.
ня̅демāчāвун орокōрвэ, где-то дяпкуталва-хинче.	получили в подарок оленей, где-то по восемь голов.
дебӈэнэлвэр дебдерэ тарэ ӈо̄нимил.	свои объедки едят эти, длинные.
и долболтоно тэгэтчэрэн.	и вечером сидит.
нуӈарӈӣтын удялтын ачир.	следов их нет.
да да.	да, да
нуӈартын мучӯчал, дюкчала̄вэр эмэчэл, орорвун, орорин тарэ нуӈанӈӣлин.	они вернулись, к чумовищу пришли наши олени, олени эти его.
тоже ӯчакки пустым би мэ̄нӈӣви.	я тоже отпустила своего учака.
тадук аӈилби, орорби илда.	потом мои эти, олени встали.
«hэвэкӣ hэлэ аӈилба одявкӣ.	«бог-то этих самых делает.
«hэлэ би эрэ, мо̄т аӈэ, бэйӈо̄ ирэксэвон олгӣкта.	«вот я это, палкой высушу шкуру дикого оленя.
«давай дундэвэ hо̄гинтуга̄т».	«давай землю пинать».
дялдӯи hэhэндеӈо̄в.	друзьям расскажу.
потом эмэрэ.	потом они пришли.
горо бичō тāду стāдотын: нямāди дя̅н километр потаптук.	далеко было там их стадо: сто десять километров от потапова.
толко школалдук hуручэ.	только из школы ушел.
«аминдӯвэр энэл hилбара.	«не говорите своему отцу.
кассирдӯ хавалча̄ф дян анӈанӣвэ.	кассиром проработала десять лет.
«кэ, — гунэм, — якут голомовон бакам».	«вот, — сказал я, — я нашел зимний чум якута».
дюр мо̄ва, мо̄ка̄рбэ оран, дуктэвурэи.	сделал две палки, две палочки-колотушки.
****	****
кешав балдырэн.	кеша мой родился.
дигали.	на дигали.
гундерэн:	говорит:
эвкӣл-да минэ исеhинэ.	не смотрят на меня.
эдуквэhин этэ̄ндэ ēкунмада̄ бакара ила̄да̄ hурурэ». —	отсюда ничего не найдешь, никуда не уйдешь». —
а то̄лӣ бидичэ̄тын чулугдыл.	а тогда были чулугды .
амтылви эмэрэ, гунми тар, аминми умнэ хэхэнча̄н миндӯю, он эло̄ эмэрэ, эр дундыло̄, агатадук.	родители мои приехали, так сказать, отец мой однажды рассказал мне, как сюда приехали, на эту землю, из агаты.
«ча̄гит тогда дявакал ӈа̄лэлдиви.	«подальше тогда схватись руками.
вот эhӣко̄тко̄н тēтēткӣ ӈэнэдеча̄вун.	вот сейчас мы ездили в тетею.
ну перегондэит эмэчо̄в, эмэчо̄вун.	ну, перегонными  я приехала, мы приехали.
горово илитча̄н.	долго он стоял.
****	****
дептилэлэтын эмэпдерэ.	продукты привозят.
****	****
нуӈартынкӯн нюрма̄чал, аямамат ичэтчэчол.	они-то подкрались, хорошенько смотрели.
бултадеңо̄с дэвдо̄йи бэйңо̄йэ бэюнэ.	добудешь поесть дикого оленя, дикого оленя{*}.
потаптулā тарилдук гиркудеӈнэрэвун.	в потапово от них ездили.
таравэ hэлэ тар гусё ӈинакинма:	потом вот он сказал собаке:
би элӣ балдиса̄в.	я здесь родился.
hавалдяпкӣн олдяча̄н-кэ.	стал-то работать.
эхӣ бэдни нуӈардуктын элэдуктын индерэн уӈун, элэ, галя, а, самая младшая.	сейчас, бедные, из них из всех живет эта, вот галя, а, самая младшая.
hэлэ дуктэмкорэн-до̄, hутэлин ёнмасилчал.	вот он стал колотить, и дети очень испугались.
гугарэтчэрэ.	звенят гугарой .
вот эдӯ-тэ индемэ дюрдяр аӈанӣва екэӈдэдӯ.	вот здесь живу двадцать лет в эконде.
эванда эчэ̄в ичэттэ.	ничего у нее не посмотрел.
эчэ, hорошо, эчэ hуктыллэ, мунэ аhаhинэ.	хорошо, не побежал за нами вдогонку.
тадук эло̄ эмэӈнэрэв.	потом сюда приходим.
вот тарбава аңанӣвэ инчэн минңи эбэкэф.	вот столько лет жила моя бабушка.
он-кэ никэлдерэ?»	что же они будут делать?»
тогориктатын тар hиӈкэрӣдерэн, би бидерӣвэ эдӯ.	только огонь у них трещит, хотя я здесь.
тадук амӣм эмэрэн.	потом отец приехал.
«юллэн», —	«начал выходить», —
орорвун манавра.	наши олени закончились.
куӈакан, ама̄ка̄н-тэ, этырко̄н инде... — илани, энӣтын.	ребенок, и дедушка-старик, и мать — трое.
****	****
мӯе гэлэ̄ктэнэ̄hинэн.	пошел за водой.
«ну, — гундерэн, — видно, иланэ тырганӣл hира̄нипкӣл, аӈэ, макитка̄р о̄да̄тын».	«ну, — говорит, — видно, три дня спариваются, чтобы были медвежата».
нуңан экун бисо̄н туруhанскадӯ.	она это, была в туруханске.
ӈа̄лэлвэ хо̄ӈна̄сал.	руки отрезали.
суглан оран-да гунэ: "эло̄ элэ- элэ- элэт эмэго̄т умундӯ бид бида бидеп биго̄т".	суглан сделал, говоря: "сюда все давайте придем, все вместе здесь будем, давайте будем".
опять hурурэн.	опять пошел.
би эhикон улгучо̄ндим эниңэhэйӣ удыгир наталья яковлевнава.	я сейчас расскажу о своей покойной матери удыгир наталье яковлевне.
эр ама̄ка̄н гусё:	дедушка сказал:
дюла̄тын иконэмил, гусол.	когда пришли в их чум, они сказали:
хо̄ӈна̄нэкэко̄р, локотчол тугэ.	отрезав же, повесили так.
би бултадям биралду дигали, чикты, дями.	я охочусь на реках дигали, чикты, дями.
э̄дяфкӣл, хавалдяфкӣл.	что-то делали, работали.
hинэ, может, бэлэдем».	может, помогу тебе».
потом нюӈунмэ hутэв балдым.	потом шестерых детей родила.
****	****
уюсэктэфкӣл.	ездят верхом.
илэдыт.	по-эвенкийски
са̄тыралба ӣсел-до̄ багдамалба локотчол тадӯ.	белых песцов выделали и развесили.
****	****
бурурэн, ёлки.	упал, ёлки.
а акӣм бивук эрупчут индерэн.	а брат всё еще плохо живет.
****	****
потом.	потом...
ая аhӣ бисо̄н.	хорошая женщина была.
