ichetnodem	приду посмотреть
goshajadu bidichotin	у гоши они находились
i e potom omoden dolbolto dolbo uzhe dolbocholon	и потом он придет уже когда настанет ночь
bokonchuchelden	пошел догонять
edin achin bichon eninngiw	мужа не было у моей матери
kungakar hujukur bingehitin-te etesow stadeldu hawaldami	дети маленькие когда были перестал в стаде работать
sundu edu edu orokor won bihe	у вас здесь олени
de	да  
chasownadu indengkitin	в часовне они жили
er tododohun hele emepdem irekselwe   ireksewe ohalba er satire ireksewon ewan	чтобы вы поверили я принес шкуру камусы шкуру и тому подобное этого песца
uzhe inigeren ororwi	уже развьючил своих оленей
pektirechen chipkarwe ulukilwe dantakilwe wes	настрелял соболей белок росомах всех
e dolgo uzhe dolgo oj gorojo itigadengnerewun sawodalwer gorojo inipdengnerew gorojo jesche	долго уже долго долго собирали вещи долго вьючили  долго еще
amim dilganman urederen	походит на голос моего отца
warak hoginipki	враг пинает
potom ami emeren	потом отец пришел
nu tala hurure	ну пошли туда
tar hele umno degilcholon dumajdesa tar beje	вот однажды когда тот улетел этот человек подумал
aja hawa tare	хорошая работа это
bejelba odawki sitaduk	делает людей из глины
taduwer lukilwi dajanalwi sawurihiniwki tuksamninkakunduk nungarnuntin ganatmasilcha	потом стрелы которые спрятал схватил на бегу и начал с ними перестреливаться
girkulcha tare dunde hergidolin	стал ходить под землей
emedere ekunmal	едут по направлению ко мне какие-то
tozowkawa game	взял тозовку
odangas gunifkil brigadir	будешь говорят бригадиром
urinengnerew	останавливаемся на однодневную стоянку
nu urge tegetcheren guluwunmi dagadun edinunmi	ну беременная сидела у очага с мужем
aminngehe nungandar nadan anganisi bine asin osan	покойный отец умер когда ему было шестьдесят семь лет
no kunto opkandi mom gurudijem obratno	но перевернув сама буду грузить обратно
kungakar әmәrә uchamila	дети приехали в учами
a dla nih	а для них
tak izredka	так изредка
edu inilderes	здесь будете жить
ewunai isefkeses gunne	зачем ты показала спросил 
oj kak orellaw	ой как мы закричали
albacha aһadami	не смог догнать
okir bakachas	когда нашел
tegekonem moldu tegetcheren	сел и сидит на дровах
nungan gunchen	она сказала
nu ulle konechno ollol tuge	ну мясо конечно рыба так
ere indengkiwun na ribotochkah kalan delimakit perekat	это мы жили на рыботочках калан делимакит перекат
hawalim hagdandulaji	работала до старости
prosto du nungardulatin ojoletin bururen edinderekin homamat	просто чум упал на них сверху когда был очень сильный ветер
mindu bichen   bi hegdi bichew mindu bichetin hutelwi uzhe	мне было   я взрослая была у меня были дети уже
uzhe halgarin eto w zemlu prowaliwajutsa	уже ноги у него в землю проваливаются
angi buniderilwe irgichilwe doldirew	это воющих волков мы услышали
bu pektirullew	мы выстрелили
a ungun tar chasownagit emepki bicho	а этот самый из часовни приезжал
taduk nu ajamamat hegdiheso kungakan	потом очень хорошо вырос ребенок
taduk olenewod odam mekloji	потом оленеводом стал сам 
dawaj palatkatki tuksahinam	я давай бежать к палатке
engnekordu uchadangkif hiwudaktu	на телятах каталась верхом от скуки от нечего делать
wertoletil degingkitin olenewodildula	вертолеты летали к оленеводам
wot nungan potom opat tar zhe mestola emeren	вот он опять на то же место пришел
dundengdulii hururen-da ertiki-kem dulbi bisotin gunne	пошел по этой земле думая вот в эту сторону мои чумы были
eruktalingkiwun girkumatpel	начинали проверять пешком
bejele asir	людей других нет
amakan lukilon osa bejetkondu ele nikor ustawatin	дедушка сделал мальчику стрелы все это самое  все
taduk beje emelcho dumala	потом человек пошел к чуму
lambaranen	прилепила
taduk nungartin eta   hewekidu   gunderen	потом они   бог думает
istanokil bejel ekur upolnomochennijil girkudangkitin	станки люди эти уполномоченные ходили
tepkelingkin	звал
nungan mune tewuktedeson ilo tala	он возил нас туда-сюда 
bagdama oron erigin ahis busle oldondun	пусть белый олень подышит твоей жене на больной бок
tar eto hargi angin oj warak tolko tepkehinen	черт то есть сатана только крикнул
bi gunelim	я стала говорить
wertoletil ora degre	вертолеты это самое прилетали
mm	м-м
taduk etirkonin budande potaptula hururen	потом ее муж умер и она уехала в потапово
nungan hanguktasa	он спросил
taduk shuraja timanektewan ewa buranildi һuruchol	оттуда шура и его друзья это на другой день на буранах уехали
tadu bolnitsa bison	там больница была
ilo oda	куда они делись
tar hele tar hurumurekin oldan tare ungtuwune ehi tar beje	как только он улетел тот человек стал делать бубен
nu tar beje kotorij ngenedechon	ну тот человек который шел
tak do zimi zimoj uzhe argishim na odnom meste	так до зимы зимой уже аргишим на одном месте
nu tam ganalchi-te ho bingkin beje	ну там стрелок-то он сильный был
edu indengkin minngi ekim olga iwanowna udigir etirkonduliwi	здесь жила моя сестра старшая ольга ивановна удыгир по мужу
aga	ага
no indesowun ajat	но жили мы хорошо
olenewodil hungtu izmeni izmenire oronmi irgihitpe	оленеводы другие изменили воспитание оленей
chajtirewun	попили чай
umukon beje tutonchanegan mindu ulguchonen ero	один человек из тутончан мне рассказал это
on nan ngelifkenmi aja binon er hutelwon mine degiwdotin dundetki tare duw dagalan	как бы напугать было бы этих детей чтобы они привезли на землю возле моего чума
dadangilwa dadangildu ileldu ororoji bungkin nulgiktewunetin debdotin	безоленным людям оленей своих давал аргишить чтобы те ели
bi doldim tar buniderilwe angilwa ngonimilwa	я услышала этих воющих длинных 
i wot mune tar sewernij tajmura archaran olloldi bejngoldi chipkardi	и вот нас северная таймура встретила рыбой дикими оленями соболями
nungardutin kete hutelin bichetin	у них много детей было
taduk hele e-dawel etere ere bu hagdanew	потом вот почему-то не стали мы постарели
tuksantesa-do tetigedukin hogdondodukin degiwuhise erdelon jangiltikikun iheldulo	побежал за одежду за спину его совсем понес на горы на камни
tar mesto aja-te	там место хорошее-то
nu togda heweki gunderen	ну тогда бог говорит
ichechelim	стала смотреть
hukuledewki	лежит
ulle ajamama bichon	мясо было очень хорошее
umukon tigise jegin namadi dapkundar nadisidun anganidu emesow	в одна тысяча девятьсот восемьдесят седьмом году я приехал
potaptula iremodichew	в потапово в гости я поехал
wso rawno uzhe pochti chto polowinu tuge halwatin ajat echew hare	все равно уже почти что половину так некоторые уже хорошо не помню
ekspeditsijadu hawaldesan hawaldesatin	он работал в экспедиции они работали
tar hele hele hurukte guso	ну вот пойду-ка подумал он
hot tarit nodanchedem	хоть этим кину
ni emesen guso	спросил кто пришел
gosiktawan hele hurum armijela	на следующий год вот пошел в армию
tegetchechon	сидел
tar ngelitne beje bilden tar kinggittu	человек стал жить у того кингита боясь его
a buchen nungan umukon tisacha jegindar dapkun nungu   nungi   nungidu anganidu	а умерла она в одна тысяча девяносто восемь шестом году
nu a nungan tegetme tadu emenmuchon	ну а он там остался сидя
nu indichowun tadu du̅ldutin balokildutin	ну жили там в их домах в их балках
nu nungan gunderen chto wot ot etogo chtobi malenkogo palmoj rubili	он говорил что вот от этого чтобы маленького пальмой рубили
e-da edende	почему нет
etirkom gunepki	мой муж говорит
bi hanguktedechaw ebekeje annaduk mihajlownaduk	я спрашивала у бабушки анны михайловны
tarigit emechol bichotin potaptula	оттуда они приехали в потапово
haktiriwchu odan	темно стало
howe gorowo ganatmatcha	очень долго стрелялся
ongkodoro	пасутся
heweki dawusadasa-te nunganman	бог ее держал
ewkil ejdere nunganman	его не замечают
gribilwa tapdara	грибы собирают
taduk doldim tepkerwe	потом услышала крики
tadu һalwetin tajim znakomijelbi bichol	там некоторых узнал знакомые мои были
ichem wolka udalin tadu wezde chagit	увидел следы волка там везде с той стороны неподалеку
dundelo emewren i gunderen	на землю привел и говорит
eto hujukukon ge igdamakan	маленький другой рыженький 
taringmi ganasiwki-da idu-do ewki nawkane	стрелял в него никуда не попадая
bi usittasaw dapkun klasstu	я училась в восьмом классе
hutelin-da monin-da josal eregerit	дети же сами очень испугались
ahiw gerbin masha	жену зовут маша
juzhnoj tajmurawa dagraw bargidawan	южную таймуру перешли на другой берег поднялись
udaltin achir	следов нет
potom gewa motiwa icherew	потом видели другого лося
taduk boloniwe tagiktam ororwo gotadana	потом всю осень пас  изгородь делал
degilde dutkikunmer tar kinggit hutelin	полетели себе домой дети кингита
internattu hawalchaw	в интернате я работала
angulda diwolda gunne	стали удивляться думая
taduk togongnerew dawiltiki i shurungnerew osholoki ulumikittiki	потом садимся в лодки и уходим вверх по течению к промысловым местам
dawatten nungarwatin	похватал их
oj nungartin gara tigewer	ой они взяли свою посуду
taduk doldiren eningehew	потом услыхала мать покойная
stadewetin darili nenecho begem darile du̅tadechel	их стадо стороной я проехал в стороне были в чуме
kire ngo	фу вонь
tung nikese-da hele bi ehikokon nungarwatin ngolefkondengow	делая так я их сейчас испугаю
nungan gunderen	она говорит
ustawan manawki wawki	всех приканчивал убивал
kojno bihim gunderen	говорит что заблудился
oror edu zhe emechule 	олени пришли сюда
kabineteldu tegettane edingo bingkiw gorojo 	в кабинетах сидя не мог там долго 
ter   wegin ere perestrojkalongahitin toli hele in eruwsu osan edu jekengdedu perestrojkadangahitin	в то время когда была перестройка тогда вот жизнь плохой стала здесь в эконде когда перестраивались
bi tuge angidangnam  dulai ngenedengnem tolgokildu   tolgokidu	я зимой это  домой еду на санях
tetigalin asir ekunda asin	у него одежды нет ничего нет
orordi bidane ororwo tahiktadadangas	с оленями находясь оленей выпасать будешь
lekarstwangiltin ngopchu	лекарства их вонючие
ororwo unatchawun tingaringe	оленей продали в прошлом году
ngolelim aha	я испугалась ага
ajakandi ujden uhikokundi	хорошенько связал веревкой
ngenektedende tadu nunganman	поведу-ка его туда
tushal uldelwi stolko	туши мяса моего столько
tar isewkeso er bidere gunne	она показала говоря вот они
owodilwe ustawan wasifkil e ekurdi brizgowateldi	оводов всех убивают этими брызгателями
potom busselden leningradtu emeren dulai	потом она заболела в ленинграде и приехала домой
ekukakun-mel gunderen heleme chipicha doren hegdimeme girginadana	какая-то говорит железная огромная птица села позвякивая
heweki hele angilduk sitalduk odawki bise bejelbe	бог вот из этого самого из глины делал людей
tar beitcheren tar demngenedukpi	он мстит за свои объедки
tak tuge prosto debdower debdower gelektedechowun bejngole nulgiktedenel	так просто чтобы поесть чтобы поесть искали диких оленей пока аргишили
hinngis opitis hegdi	у тебя опыт большой
hangedefkil depdower nulgiktededower	следовали за ним чтобы есть кочевать
pekteroningnende sipkanme	стреляешь соболя
ewki hilbere amaka	не рассказывает дедушка
nonon anginkif nengnenit mole ojonmunongkif	перед этим это делал весной дрова сплавлял несколько раз ходил
minngi sestraw hegdimer turskaja hristina dmitrijewna edu hawalchan	моя старшая сестра турская христина дмитриевна работала здесь
wojnaduk bichon kujki	с войны был глухим
ugiskikon degilipki dunde	земля летит вверх
kergehelin eregerit hokorsol ilo odan er gunne	семья совсем потеряла говоря куда он делся
taduk eninmes huruwre	потом твою мать увезли
dada amaski hururen	дядя позади поехал
borongkon gerbisi amakaw bison muktenguduk	дед по имени боронгкон был из рода мукта
badaraltin badarami-te gunifki dundewe	лесные пожары поджигать лес стали говорит 
toli amim oriren hamanme utokogir bahilajwe	тогда отец позвал шамана утокогира василия
takuju dal ehi	такую даль сейчас
homotiwa bi rasskazhu on wachaw	медведя я расскажу как убил
palatkala dagamallawun	стали подъезжать к палатке
e tunngawa bejewa hihur   kep   e uim	о пятерых мужчин я связал
halgartin kepusol bisotin	ноги их опухшие были
tugeniwe tagiktarawun marteldula	всю зиму пасли до марта
ke pektirekel beje	давай стреляй парень
gorowo bikenem heweki emeren	бог пришел после долгого отсутствия
er portala emellew	стали подходить к этому аэропорту
albaraw eja-da angidami wadami ni bejngol	не могли ничего добыть ни дикого оленя
hoktelwer ter nungartin esel hare	дорогу свою они не знают
wertolettu dәgildәw	на вертолете мы полетели
tartiki tuktihinen	залез туда
ullidengkin kokollolwa angiduk irekseduk	она шила рукавицы из этого самого из ровдуги
wihodnoj	выходной
wse	все
amim toli buslelcho bison	отец тогда заболел
duktekon indewkil	вдвоем жили
hukuledere hukuledere	лежат лежат
epet hururen	опять ушел
dazhe gunipkil izbushka guru izbushkabal echol emone chto li	даже говорят избушку какую-то не оставили что ли
tung nikewki-da ekun-mal mujan gennowki iduk-pel biso	делая так ходил ему за водой
akim bison aleksa gerbin aleksandr	у меня был старший брат по имени алекса александр
nu umnot angiran pektirenen nunganman	ну сразу это выстрелил в него
nungan gunen	он сказал
potom doldim m-m-m nekederiwe	потом услышала как делает ммм
to aja ajamamat dolsatcha-de	хорошенько прислушалась
e bihe	да они есть
bunille tare angil ngonimil	завыли эти длинные
bolshe omngom	больше не помню
etirkonin nunganngin udigir wladimir konstantinowich	ее муж удыгир владимир константинович
nu ehi ehi ehite gorod tadu	ну сейчас сейчас-то город там
tadu maril jaktali dinngilecho tadu	там кусты вдоль ручья он бежал там
terehedene tuksahise nunganman	побежав колотит его
da bi gunderen amutwa upkatwan hurupdai tar hunngi tigehun hujukun engeni	да говорит я все озеро принести  но ваша посуда слишком маленькая
ichechelim ajamamat	я стала хорошенько смотреть
nu bednenko	ну бедненько
uchakki dawamalcham menngiwi uchakki	учака схватила своего учака
amargut okinmel emedem	позже я приду
hele dumajdana dumajdana tar beje angcha	вот этот человек думал думал и это  
nungandun tare hawaline prawitelstwo buson dur ordenme trudowoj slawi wtoroj tretjej stepeni	ему это за работу правительство дало два ордена трудовой славы второй и третьей степени
er ekspeditsijal ora hutelwew bufkone	эти экспедиции сделали моих детей задушили
һojduk muchucha	из тундры вернулся
odnazhdi umno etirkom umno etirkom angiran bakaran abdunma	однажды мой муж это самое нашел берлогу
inihilderes	живите
taduk huidigif ahatkanngif duga baldiran wala gerbisi	потом младшенькая девочка летом родилась валя по имени
molkewutcham	мне померещились призраки
burduka asin	муки нет
hargi-luwar-ka tar iseso-do tumnisa dereldutin taringildun tar heweki bejengildun	черт-то когда их увидел плюнул на их лица на лица этих самых людей бога
utole-te ehi-de ororduji hjerdutin hjerwatin minefkil edewer hokorde   hokormi tarwo orone bakadatin bakadawer	раньше и сейчас оленям на ушах уши режут чтобы не потерять если потеряют этого  найти чтобы чтобы найти
ter engnekorwe nungardulatin tastasawun ohotnikildu buttotin bultamnildu	тех телят мы к ним гнали чтобы они раздали охотникам охотникам
erupchu huruwren	плохо увез он
tar hele umno gennohiso bejelwe okanem angja muja	вот это однажды бог сделав людей пошел за этой самой за водой
ila nungartin ora	куда они делись
ogdoske	дуся
igarkaduk elo prihodili ororak uguchchanal hantajkala tar hine nanchitchikajemi	из игарки сюда переходили ехав верхом на оленях в хантайку когда тебя я нянчила
togda toli ichenosinew sewernaj tajmurala	тогда тогда поехали посмотреть на северную таймуру
toli nginakin turosi biso	тогда у собаки была речь
i wot bi tug hawalim	и вот так я работала
tadu bi isdechew nungan bichen e baldichan primerno umukon tisacha dapkundar dapkun nungidu anganidu	там я видела она родилась в тысяча восемьдесят восемь шестом году
jangkakundula emewso iheldula	на горы принесла на камни
bi-ke cho	я-то что
tegekel	садись
nungan dazhe guningkin w berloge epko ware   abachi	он даже говорил в берлоге нельзя убивать   медведь
dun achin eche angidara opdere	чум не построен
a tala telegrammuwe bakachal potom uzhe ushli kogda uzh dawno һawaichalawun	а там телеграмму нашли потом уже когда уже мы давно ушли гулять
ajamamat ohotilsadechaw	очень хорошо охотился
i wot gunen	и вот он сказал
i wse	и все
tartiki ugusakit hurungnende	туда верховым идешь
mortin mortin achir	самих нет
tungadan ororwo	пятьдесят оленей
potomu chto erupchuje deptileje kotorij esikotkon depdengnere engkiwun dewre	потому что плохую еду которую сейчас едят мы не ели
nu i emepchotin nunganman jerbekedu	ну и привезли его в ербогачен
tar amingahaw emeren omolginun 	отец покойный приехал с молодым человеком 
gorodtula indam dudinkadu	в городе живу в дудинке
hegdi kete orosil ewenkil hutelduwer anangiletin engkitin bungkitin namisane	эвенки у которых много оленей это делали давали своим детям важенку
tarit-de nungan gunderen	потом он говорит
taduk taringin  	потом тот  
irtiki biren dus	где находится твой дом
ngenedene ngenedene dukchalwe iseso dundegesin-te	шел шел и увидел чумы как на земле
kunga ngenewungkif bejelwo	я возил людей
hurur   achir ora	не стало их
uldengiltin lokusadawkil tulilo	мясо их висит на улице
nado s utra zhe hururektin	надо с утра же ехать 
nu ajat bidengkiwun	ну хорошо мы жили
konechno konechno wse wrema	конечно-конечно все время
no pektirokel ajamamat	но стреляй очень хорошо
danduk duldo hele-ke ngenedengōtin	за двенадцать дней доедут
eningehe guningkin	покойная мать говорила
hurure erdelon	ушли совсем
abachi tegeren	медведь сел
tar kinggit guso	сказал тот кингит
bunille-he uregendu uregen ojodun	завыли на горе на вершине горы
taduk dudinkala hurum	потом в дудинку поехала
tungiwe-ne mindu tu tungewa otmetkawa bupkil patorkelwe polushishaw ene girametne bihe monngitpi opititpi hawalnatpi oron hawawan	пятерку вот мне отметку пятерку дают пятерки получал будучи неграмотным со своим опытом с проделанной оленьей работой
edes degiwuhine-da erit wattingaw hune guso	если не унесете поубиваю вас этим сказал
on keden jopu bire tarba bejewe irgitcheri nungan	как же ему  кормившему того человека не быть жидким
heweki hururen	бог ушел
ekunka nawernoje nginakir kikirkal kuikotchenel	это самое наверное собаки покусали когда дрались
ewedit turonderew	по-эвенкийски разговариваю
potom ahilaren	потом он женился
ilo idu tadu tala hurupki tara hurupki	куда где там туда пойдет сюда пойдет
amim emederen	отец мой идет
emenmure nekurwi ahamil	остались младшие мои сестры
nungan aderen	он спит
kojnonun-te birokin ulikel guso	раз заблудился накорми сказал
opat tozhe ohiktakardi opki	опять становится звездочками
nikisere emewuwki	уточек приносит
tare dapkun klaspe manasaw tutonchanedu	восемь классов закончил в тутончанах
ehi polno binore nawernoje	сейчас их полно наверное
eningehew ngolelcho	мать покойная испугалась
m-m	м-м
jokederen	кричит
ohotnik bison	охотник был
ekinin tozhe	старшая сестра его тоже
cherez goda   annganili ilallali   ilalduli nengne tali zhe ngenedechow umukin na uchage uchaktu	через года   через три года весной там же ехал один на учаге на верховом олене
mune huruwupki ilo dula	нас возит везде в чумы
kak goworat ajjaw merwer	как говорят выручили самих себя
dewso niso  	он поел и это самое  
kungakan tadu hutetin biso	там был их ребенок
a eninmi uzhe dapkun annganil kak achin ocha	а мамы уже восемь лет как не стало
ngelewsi-ko ama-te amawun ewki doldire	страшно это дед наш дед-то не слышит
nanmaktal asir bifkil	комаров не было
ke gunen bokonchukel nunganman	давай говорит догоняй его
tuge tuge de   tuge tuge okallu	так так делайте
gunipki	думает
etem etem bol    etem etem goworu tala bolshe angire	не буду не буду больше не буду не буду говорю туда больше это самое
a nekunmi wasilij a abachutkan bil   echen-ton hegdi bire dwuhgodowalij huchuhicha kotot	а мой младший брат василий а медвежонок был небольшой двухгодовалый ткнул пальмой
tuksadaran tuksadaran	бежит бежит
nu tala echawun-ke ajchawun nu i wso	ну там это сделали добыли ну и все
tiniwechawudu ngenedechowun	мы шли позавчера
uzhe nungannun indengkiwun	уже с ним мы жили
tolko dirikan emonmucho	только сопка осталась
eknilwe tadu bidere lena tona	мои старшие сестры там живут лена тоня
dapkali girkum	по берегу я ходил
hurure tali du̅liwun ngenere	поехали туда через наш чум проехали
potom uzhe tala hannguktalim	потом уже там я спрашивать начал
e̅ etirkor ehi tarilwa dona	да старики сейчас тех вспомнили
bi bultadem chipkanduli	я охочусь на соболя
degiwufkondengow hamij tar dui dagalan	заставлю их принести меня по воздуху прямо рядом с моим чумом
er-do-te mudaningiw hegenim huwulwon	вот и конец я рассказал все
guchowdadoi nikochow emokel	хотела сказать оставь
potom ichesinim amaskii	потом посмотрел назад
dәgrә samolettu	на самолете прилетели
bi-de echew popalle	и я не попал
kungakan tuksahise moloro ojokokurwotin ugidoldulitin tuksahindana	ребенок побежал убегая выше вершин 
bi gunim	подумала
a sejchas ja pensijadu bidem	а сейчас я на пенсии
taduk nungan ujden nungarwatin	потом он привязал их
oldokorwo ehikon nodadem tala	рыбок сейчас брошу туда
institutilwa manasatin	институты они закончили
chajnikilwe hujupcho	чайники вскипятила
ajamamat bidere mittuk heleket	очень хорошо живут лучше нас с вами
inichederil bidere inichedenel bidere	запряженными оставались еще
uldilen odaf	я стала мастерицей шить
ajisifka buslewe oronmo tatarwen ajisifka	лечить надо больного оленя чесотку лечить надо
potom umno jesche ulguchonderen	потом однажды еще рассказывает
potom ichetcheren peschera	потом видит пещера
hele tar-wahin bidengnogin	пусть он живет
dawaj hikilden nungarwatin mukondi	стал мыть их водичкой
silno tetedu edu-de hawaldami-ke achin hawa	сильно ни в тетее ни где-то работать-то не было работы
ranenijengilwi ahaktalingkin	раненых своих добивает 
pensioneril starikiw minngi pensioner bichon	пенсионеры мой старик пенсионером был
eninmi garan-da amakatkie hururen	мать взял и пошел к дедушке
o jopun-keme ho	о очень жидкий
ganalchil hongetin guso	начальник стрелков сказал
taduk tastawun namadi engnekonme hujukoriktelwe	оттуда гнали сто телят одних самцов
taduk hingilgen bururakin hungta orokin elun kapkasilingnaraw	потом когда снег выпадет когда глубокий будет снег бездорожье мы начинаем капканами охотиться 
nu taringitin potom opat uwiriwren	ну она потом опять поднялась в воздух
gunno gucho һari beje ngenederen	подумал знающий человек едет
widno amundarka	видимо он испражняется
ilitchechon	стоял
chipkakanme isede chipkan gunektin amaskii tuksandende	видя утку если говорили утка ты назад убежишь
ame̅ ekukan ngalen harbaldediren tadu	папа кого огромного рука растопырена там
mangil huktidere hirandere ijundu	медведи бегут спариваются в июне
no hutelwi tak-to daj bog indere upkat	но дети мои так-то дай бог все живут
tung nikese-de huruso	сделав так он ушел
gugarele doldim	гугары услышала
efkil onore ahatkar tawer	не вышивают эти девушки
nu ja jesche i za leto rasskazala	ну я еще и за лето рассказала
ewilen	стал играть
potom gela dula huruden	потом в другой чум поедет
no tak konechno mongiw angiw choliw iledi kak on omngodenni	но так конечно свой эвенкийский язык как забудешь
tuk kedene abdundula turgam	так наткнулся на берлогу
bu bi doldim	мы я услышала
bejewe hereket owki	мужчину отдельно делал
opat hutesil	опять с детьми
hele isewkondengow er hergudu dundedu bikonem emem gunne	вот покажу сказав что пришел побывав на нижней земле
girkuna	пешком
bi pektirenem	я выстрелил
nekotorij hagdikar olenewodil tar dawusedere oronme	некоторые старые оленеводы те держат оленя
a tolko hagdanmi osan ribakom	только состарившись он стал рыбаком
hurkokochonme ele eleli ocha pramo bedni	вот как мальчик как раз прямо стала бедная
tawungnerewun potom utrom na̅n һangkelduldule̅ namngnerewun na̅n hurungnerewun	ставим палатку потом утром утром опять на санки на санки кладем опять едем
er ungun mina aminim bichon	это отец мой был
umukonme bultarew	одного добыли
emedengnerew emedengnerew	подходим подходим
eldu-ka nu kak skazat-to eti kommersanti komme    kommesar   kommersasheldu uniengnerew shobdorwe ulukilwe	этим ну как сказать-то эти коммерсанты коммерсантам продаем соболей белок
hutelwi er guletin ere ajat	у моих детей дом это самое хорошо
deptilele k    deptilelwe iruk   iruktedangkitin orordu turuduk kislokandula birali tunguskali	продукты возили на оленях из туры в кислокан по реке тунгуске
oldonwen produktele emewupkil oldonwen һuruwupkil	рыбу продукты привозят рыбу увозят
gedu kergendu hunngtu oronngitin hamilkin	в другой семье другая отметка у оленей
huksillaldi girkudachawun	мы ходили на камусных лыжах
nu i  	ну и  
opat amim opat mine hurupden	опять отец меня везет
kure uteleptiduk juchal dawno tar 	давно вышли из огорода
glushnew mihail pawlowich bishon hegdi doktur	глушнев михаил павлович был большой доктор
ge hunadif renata inderen norilskadu	моя вторая дочь рената живет в норильске
dolsatcheren tegetcheren	слушает сидит
amim eninmew hagdi hagditmer bison	отец матери старше был
a bi emerepte hunnun numotchildew ehile	а я мы с вами приехали и я с вами стали соседями вот
uguchakildi ranshe ngulgingkiwun	на верховых оленях мы раньше кочевали
degiwuskeldu dukte guso	отнесите меня по воздуху вдвоем сказал
tar dukchaldula emeren derukonem	устав он пришел к тем чумам
skolko wertolet isissa degipki ehi	сколько вертолет летит сейчас
hergiski-kun buruso erdelon	совсем упал вниз
warew toli ketememewe ullelwe ollolwo	добыли тогда много мяса рыбы
sa   sadiktula engkif girkura	в садик не ходил
bultadande dengkejawel kapkandu tagadan	добудешь соболей в капкан попадет
uchichildә әdu hәgdi	учиться стали здесь большие
o dolboltono emedem	о вечером приеду
a warak nunganman hangukchadaran	а враг его спрашивает
bu amarkandun emerew nulgirew	мы после него пришли прикочевали
bi kungakan beledengkif luhu	я ребенок помогал всегда
tadu indengkim   	там я жил
nu monme tetiwuldan nungan	ну сам зарабывать он стал
ngenederen ngenederen ngenederen edengo baka   bokono	идет идет идет не может догнать
amaka tar etot  	дедушка этот  
bu dagamatchow	мы приближались
ulumidesotin	они белковали
wes palets wot takoj tolschinoj zhir salo	весь палец вот такой толщиной жир сало
tadu dun biso tar kinggitngi	там дом был этого кингита
anan targasin mu idu-wel biso	специально такая вода где-то была
mozhet irgidere mozhet	может вырастят может
hanguktachaw	я спрашивала
monin opat eto bokonchulden tar bejewa ekun beje ngenecho	сам опять стал догонять того человека который шел
hele amininhinche tar angi biso	отец наверное это был
opat dunde gorolo degilipki	опять земля далеко летит
potom tadu stadolatin nulgichowun nungardulatin	потом туда в стадо аргишили к ним
guniwki biso tar beje	человек говорит
akinmef tar eso nido nido gada	старшего брата моего никто не взял
enintin ukubdegin nungarwatin	пусть мать их кормит
degiwuwkondeso biso ojitin ukkanem	заставлял нести по воздуху сидя верхом
potom krasnaja rechka tadu indengkiwun	потом красная речка там мы жили
tar gulcho	подумала
gunem	сказала
i angilcha gadasilcha	и это начал стал гадать
ni-wel ngenecho halgardi hegdingekokurdi	кто-то прошел большими ногами
ekel nidu-de hehene gusow-luwar 	я же сказал тебе чтобы ты никому не рассказывал
irgisilda	вырастили
kak erkon dugani chuka baldiran uzhe wse nulgihinew	как маленько летом трава вырастет уже все мы начали кочеввать
tug nikeso-de hewekinun girkiladewki biso	 дружила с богом
beledengkitin nungandun ororwen tahiktedene monin-ta tahiktedengkin	помогали ему оленей его гоняя и он сам тоже гнал
tadu tar umukon dukchala iso-do tar beje	потом этот человек зашел в один чум
lukilwi lukilwi bira dapkadun tugartin iliwsa-da	свои стрелы свои стрелы вдоль них на берегу реки воткнул
er nan ekun kungakanin tegetcheren	это еще что за ребенок сидит
tug-de kete hutel-du manawra hute    hutelin eninngeheji manawra	так многие дети мои кончились дети моей покойной матери кончились
owsankilwe dawungkiwun do ekun	овсянку ели желчь какая
tak-te ele	так-то вот
nu onokow goromomo bichon bali	ну бабушка очень долго прожила слепая
hilatna dewuwki tar uldeje emewrekin	когда тот приносил мясо он ел его жаря на вертеле
bi hujukun bisof	я маленькая была
gunen	сказал
etirkon buslәldәn	муж заболел
taduk tar tare tadu-da emkejew osatin hekiduk	там же люльку мне сделали из большой лиственницы
tulosingkiw kapkara	ставил капканы
bu-wehin ajat amija akin-da ajat oldowo bultangkin	мы хорошо отец брат хорошо рыбу добывали
patij ekspeditsija moskowskoj	пятая экспедиция московской
hele ere prezident hungtu odakin-te putin osalan hele inmun ajatmer osan	вот этот когда президент другой стал путин стал жизнь наша лучше стала
togda amakaw ureldu motimidangkin-de	тогда дедушка охотился в лесу на лося
potom ajamamat ichechellew-da nungan muntiki ichetchene	потом мы стали хорошенько смотреть а он смотрит на нас
ranshe aminmi ekun bishon	раньше мой отец этим самым был
dapkunma klassil etem	восемь классов закончила
burandi girkuna kigloldi ontikin-te	на буране пешком на голицах всяко-разно
taduk eto heweki jesche raz ikteren-de	потом бог еще раз ударил
ischa-da tar dukchala hegdildulotin ischa-da moldutin tegeso urkodutin	дойдя до этого большого чума он сел на дрова у их двери
eleli stadowe gnali tuhardeduk	как раз стадо гнали из тухарда
ekun odan	что случилось
amiw akim bishon iwan nikolajewich nikolaj jegorowich amin eni	старший брат был иван николаевич николай егорович отец мать
orordi huruldingkif dalnunmi kergennunmi diski orortiki	на оленях уезжал вместе с родственниками с семьей в тайгу к оленям
nginakirtin aiwukkakur hukulodewkil	собаки у них лежат очень сытые
nu on bi ohotichaw	ну как я охотился
hargi emekteson edu bejengilbas tumniren-da hururen dereldutin	черт приходил оплевал твоих людей и ушел на лица им 
gorowo inchon	долго жила
timaltane bu etirke̅nwun dezhuridergu һuteltin adapkil	с утра мы с мужем дежурим наверное дети наши спят
engnekel nunganman ere ehaktara	не делай это не трогай его
inwalid odam er orordu edene hawaldana monmi ugrobichew tuge	инвалидом стал при этих оленях это самое делая работая самого себя угробил вот так
ami mine teruttan guleldulo	отец позвал меня в поселок 
klaradu achin ochan nungan	при кларе ее не стало
ambardu bisowun	на рыботочке амбар мы были
er bi herguduk dundeduk emem	это я пришел с нижней земли
luchamnil girkudara	русские женщины ходят
e nginakir taduk archamkadawki	эх собаки потом выходят навстречу
tadu hojdu tegewkoso dun isewridun	там на тундре он их посадил где был виден его чум
achir oror tare	нет тех оленей
ohala mongnideden	камысы выделывала
tegemije gennodam ullewe	завтра заберу мясо
taduk nungan hururen	потом он ушел
engnem nungarwatin isere tunga anganiwe dan anganiwe	я не вижу их пять лет десять лет
bokonchuchelden nunganman	начал догонять его
taduk gef omolgif sashaw tuge baldisan fewralendu	потом второй сын саша зимой родился в феврале
a kogda amingahaw emengkin	а когда отец покойный приезжал
bi-ke ilmakta bichow	я-то был молодой
ewa ngeliwsipchu guson	что страшного сказал
illan lapeldi	встал на лапы
gunderen	говорит
uchakki ere angim uchakki pustim uchakki	это самое своего ездового оленя отпустила ездового своего
imuren ejan bichon eto	жир такой был это
putewurtin ngopchu	мази их вонючие
angadakarwa dajakal i eto engehijes budem	спрячь сирот и это дам тебе силы
w sorokowom godu w sorokowom godu rodilas	в сороковом году в сороковом году родилась
bi gunem	я сказала
taduk musum	потом вернулся
ekunme gogodepkil tug	кого так лают
ulokis ho guso	ты очень сильно меня обманула  сказал
ngeneren ngeneren	шел шел
bi uzhe kali odam	я уже большая стала
ogon	сделано
hawalim tozhe	я тоже работала
ungtuwunmi gasa	взял бубен
danduk nungun annganisi biso mindu	шестнадцать лет мне было
wot prowodnik gundere	вот проводник говорят
rowduzhnije rukawitsi	ровдужные рукавицы
i goshajadu nginakirwi achir tadu	и у гоши моих собак там нет
ustawatin manasa lukilwatin dawana garpawki mortikitin	всех прикончил хватая их стрелы и стреляя в них самих
sitaduk bejelba owki-da taduk muwe gennewki iduk-pel-da	он сделал людей из глины потом пошел набрать откуда-то воду
muchum	я вернулся
edidukki hukiteje obratno garan	у мужа обратно взяла свой живот
tar hele isewkosilcho tar uganalbi	вот он стал показывать то что принес
ohalba isel ahal	женщины выделали камусы
wot tak wot	вот так вот
horosho angti ekun-ka tadu	хорошо этот самый там
umno nulgischowun	однажды мы аргишили
nemulemnin iwkil ergesin	так они мягко выделывают
so ajat indichetin	очень хорошо жили
tuksama bingkif bi kungakanduji	я быстро бегала в детстве
taringin uliso	та покормила
angilin herangilin tolgokidu bidere	это жерди на санках
sipkaminade kislokandu guniwkil dengkeminadi	охотиться на соболя  в кислокане говорят охотиться на соболя 
onedidangas taringilwi ni-ka alitin ongkolitin	ищешь их по краям их копанины
nu i idu-tonu	ну и туда-сюда
nu a mitkit nawernoje birke hegdi samolot ili nlo	ну а по-нашему наверное большой самолет или нло
wospitiwat omngom one	воспитывать забыла как 
s juga	с юга
ekunma odande	что ты делаешь
ekun nunganman engehin	кто его сильнее
monin chaski ngeneren-de	сама дальше пошла
bejngoje emewuwki	дикого оленя приносит
hutәlwi hәgdiharә	дети выросли
er ahatkanme ewunawer gadas ewa nikodon	для чего вы возьмете эту девочку что вы собираетесь делать
ororwun uch   namasal akchudapkil	наши олени важенки рвались
guso	сказал
potom hihewe hegdikokunme emewren	потом принес огромный камень
buson digin klastu uchitngahiduw	умерла когда я учился в четвертом классе
achin edu oran	здесь не стало
ekun-ka horosho huruchotin	это хорошо они пошли
hu hutow bideren tadu	ребенок есть там
minngi er ehatpi edengo bihim hurure	с моим этим глазом не смогу поехать
edu hawalilchaw	здесь стал работать
ororwe tiningnerewun wesnoj w nachale ijuna chtob kormilis do komarow malenko nabrali 	оленей отпускаем весной в начале июня чтоб кормились до комаров маленько набрали
oj-oj-oj harpukan	ой-ой-ой шутник
hegdingemi-kenche bichon hag   hagdimikan bicho	он был вроде большим большим был
heweki gunderen	бог говорит
nu taduk arankanmɔ umishkanchengnerew	ну потом понемногу выпиваем
ohalwe monngidakal gunne	камысы выделывай – говорила
oj ekun hegdi bichon	ой какой большой был
nu ho engehichihinche nungan aga	он очень сильный
nu pektirelim	ну я выстрелил
beledengkiwun	мы помогали
ngenecho   nulgidechowun gorolo polmesatsa mesats dulinman began oj mesats	аргишили далеко полмесяца полмесяца
tar edo   tododohun hergudu dundedu biso gunne ere emewum hele er ohalba ireksewe satirewe ere	чтобы вы поверили что я был на нижней земле говорит вот я принес эти камусы шкуру песца
brigadir one hawaldashaw hawaldashaw	я работал став бригадиром
dukte bidere	вдвоем они находятся
toli hulukokon bishow	тогда я маленький был
tarit oron kete irgifshon amaski	поэтому оленей много воспитывали раньше
bokonon	догнал
mune epkil gada	нас не берут
bi angim ngolelim	я это испугалась
hajale idudo tukdo	нету нигде так-то
taduk-ta tug-do tadu buso	потом так-то он там умер
minngi ororwi bingkitin	у меня олени были
wot tarit nado hewekiwe wsegda pomnit	вот поэтому надо всегда помнить бога
gundem	говорю
ekumaje-da bultaji bultadengat orondi hurumi	хоть какую добычу оленями пойдя добудем
elewatin otnesli	все отнесли
buren-da tar-da manawren ilo-ke odan	так он умер кончился куда же он денется
bultarew taringngar	добыли его
sowhoztu hawalchaw digin anganiwe	всовхозе работал четыре года
tadu archarewun	там встретили 
epki bichen doldire	не слышала
diktelwe ungkulidecha taringmer	он ягоду в рот клал
nginakin  	собака   
kutuje asindu efkil baldire	у несчастливого не растут
tar dundengdulii hururen hururen	шел шел по своей земле
tar hutelin hanguktawkil bisol	дети стали его спрашивать
kangkit mirenim	быстро вышла замуж
nginakinma gulcho	спросил у собаки
himulawki	молчит
mine tawerke erke utom	меня узнала ли нет ли
eningehe gundesen	мать покойная говорила
a suda	а сюда  
tar minngi entilwi tare mine irgidesol ajat irgire mine	мои приемные родители хорошо вырастили меня
tadu bichowun	там были
tihise tunganama oron batiknen istado woti bingkin tihise tunganama	тысяча пятьсот оленей вплотную стадо было тысяча пятьсот
tar bejetkon udalitin huruso ilkendulitin	тот мальчик пошел по следам по зарубкам
nungan mine anachan i potom huktilchan	он меня толкнул и убежал
idu	где
toli istanokil bishotin	тогда станки были
nu tuksadaraw koje-kak	ну бежим кое-как
tarit-ta taduk-te һujetchowun emehichowun amaskiwer	оттуда потом разъехались поехали обратно
erkondu ichewrit nawernoje birke	отсюда наверное видно было
hurum ichetnom	я пошел пошел посмотреть
tar mut optihiniwki-da taringilin aruwkil bisol	этой водой брызгал и эти его оживали
helekokundi nunganman dasnawan oran	из железа сделал крышку
kak raz bushshedechow toli	я как раз болел тогда
mortin hawaldara	сами работают
dundengtikii hurulmi hurupdengow	когда пойду на свою землю унесу
ang urkedu ujuchededera angma chipkakanme	это у двери привязывали это самое утку
her hergula dundela burum girkudana emukin bultadene	упал на нижнюю землю когда ходил один охотился
potom sadiktu hawalim	потом я работала в детском саду
oror manawulda	олени кончаться стали
a usitchan leningradtu	а училась она в ленинграде
nu a tak chego  	ну а так чего  
aminmi gasan ekunme kruzhkekonme chiktilwe	отец брал это кружечку бисер
nul    nulgichowun-te tselij nulgiw itikirwi ngenewumdek	аргишили-то целый аргиш пока вещи свои отвозил он
nungan emeren	он подходит
dongototchene	замерзает
potom emere	потом они пришли
mirison nungan aminduf ilandar anganisi bine	она вышла замуж за моего отца будучи тридцатилетней
dewugin	пусть поест
nu bingnere tadu	ну бывали там
bi tozhe bi hawalchaf eto kolhoztu hawalilim	я тоже я работала это в колхозе стала работать
tarkakundi angillaw	вот ими стали это самое 
taduk-ta potaptula girkujichawun	оттуда в потапово ездили
prawda bidere dur hunadilwi mirnijdu bidere dur	правда живут две моих дочери живут в мирном
wot ichetchengkiw eninmi  	вот смотрела на маму  
nu	да
okiwa gunipki tegesim esew hare	сколько говорит сидела не знаю
hokonono	жара такая
toli purgalcha bison	тогда пурга началась
tar ulgusondengkitin	так рассказывали они
ekeldu nikogda ekeldu niwe-de ang-ke obizhatte	никого никогда не обижайте
dapkun begasi bisof bi hujukukon	восьмимесячная я была маленькая
a m-m	а м-м
nungan pektireren	он выстрелил
ororwo isesingkin	оленей посмотрит
e tar uchakilin huktilchel tuk-kon	а те учаки его убежали вот так
ororwo gәnnohinәw	оленей отправились забирать
o engehiw achin	о у меня нет сил
e angi er gundem aja bicho bimche	это это самое говорю хорошо было бы
kislokandu indena dan ahisi bisof tadu e-	в кислокане живя женатый был там
eninduji beledengkif	матери помогала
amngawan angakellu chtob nungan juldon tar changit juldon abdundukki	вход откройте чтобы он вышел чтобы медведь вышел из своей берлоги
umukon orondu kinggilon biso	у одного оленя колокольчик был
dilwew potsarapal	голову мне поцарапал
ekunda asin deptiletin asir	ничего нет еды нет
bi ehikon emamija tancheldem eto nungarwatin	я сейчас буду их нарочно тянуть
on tugi ngenewufki-te prowodnik bine	как так отвозит будучи проводником
eninngehe gunderen	мать покойная говорит
nekurwi ilen ahal edu bidere	младшие сестры три здесь живут
dolboltonomok emengnem	только к вечеру прихожу
nulgiktefkil	кочуют
iren umukon dukchala	вошел в один чум
uregendu kaltirdu tadu	на обрыве там на склоне
dumaduk juso-do tepketcho	из чума вышла и покричала
nungartin dezhuridepkil nu a tirga mi bu һawaldangnerewun ni-ge jo̅	они дежурят ну а днем мы мы работаем кто же
taduk ustawatin-te manaran	потом всех прикончил
angi popowi bili tozhe ewengkil	эти поповы были тоже эвенки
uzhe kali osalai nungan hawalildan zwerofermadu	уже став большим он стал работать на звероферме
e nu ertiki zhe unguntiki bine birke nawernoje	да ну туда же в сторону того будучи были наверное
palakineduwer baldim	я выросла в плахине
erdelon hurupsol tar bejewe	совсем унесли того человека
samolet horosho olenej horosho a oleni luchshe	самолет хорошо оленей хорошо а олени лучше
uste bejewe haren beje	человека знает 
ogdokosokonwi karijasanmi lukcha-da amardukin tuksadane	он снял свою парку с шерстью свою замшевую парку и бежит сзади
taduk iremidechowun tali wtoroj stadodu perwij stadodu	оттуда туда в гости ездили во второе стадо в первое стадо
ngelifsipchu-keme erupchu ewiwun-do bimi etekel etekel	очень страшно перестань перестань потому что это плохая игрушка
bejel ororwe gatte	люди оленей разобрали
umno hele beje umukon bultadesa girkudasa sipkamidesa biso	вот однажды один человек охотился ходил охотился на соболей
guso tar beje	сказал тот человек
bejel-ke nungun bisotin bukokutte	мужчин шесть человек было поумирали
wot mom edu indem poselkadu hantajskoje ozero	сама я живу здесь в поселке хантайское озеро
ehi wso ni poselkal dazhe netu	сейчас все ни поселков даже нету
dongotomi edu biso bimchel	если бы замерзли были бы тут
akim uzhe har hagdi odan	брат уже взрослый стал
gde-to nawernoje demngenen tadu birke ekun-ka	где-то наверное там его объедки что-то 
etirkem wasilij iwanowich sururen gennesten orordi sawodalwe genneren emewren	муж мой василий иванович поехал чтобы на оленях привезти вещи забрал привез
uchittangkif uchamidu	учился я в учами
potom chaski sururew hereket hereket hoktet sururew-ke esile	потом в сторону поехали другой тропой поехали тогда
tajmurawa dagraw	через р таймуру переправились
taduk hele nungan nunganman umkanem nan gukanem taduk ganatmasilcha	потом это он его   стал стреляться
amin awipdafki eningehi aminin	отец дорогу делал  отец покойной матери
muchuderaktin ere udadutin ihicha-ke bicho	когда они возвращались он на дороге их догнал
nu nungan tikulden i dawaj tuksahinen	он рассердился и давай бежать
timatne elewon ora	утром все сделали
bi etem hindi girkitedemi	я не буду с тобой дружить
hulukunduf bu nulgiktedengkiwun ere ambarduli kulumbeli	когда я была маленькая мы аргишили на этом самом по рыботочке амбар вдоль речки кулюмбе 
dudinkala norilskaduk walektu	в дудинку из норильска на валек
mudu er-ke ange irgektelduk tegetchechotin	в воде сидят от паутов
gunne dumajcha tar beje	подумал тот человек
ororwun hutole kete bisotin	оленей у нас раньше много было
taduk nan ulumu    ulumingnerew ulu   ulumongnerew	потом опять уезжаем белковать
bi ungtuwune okta er irekseduk	я сделаю бубен из этой шкуры
ketewo orolorwe bungkitin orolongme	много оленеводам мы давали оленеводу
ujden ajat	хорошенько привязал
amaski tepkedana tuksadam	назад я побежала крича
tar ireksengmi angdan-da oran tar ungtuwune ehi tar hektakarduk mojan okanem	сделав из тальника каркас он шкуру это самое и вот он сделал бубен
inektengkitin	смеялись они
eninmes huruwren	твою мать увел
nu prodajdangkin zdawaj zdaningkin magazinduda tar kak trudodni	ну продавала сдавала в магазин-то как трудодни
eduk oran mugdekon	откуда взялся пень
ororwo ajichimni	оленей лечащей врачом оленей
moladengkif	дрова готовила
ungtuwunmi gakanem ungtuwunmi luhu duktedene ojitin	взяв бубен в бубен все время колотя наверху
no wso rawno etem omngore	но все равно не забуду
potom turpakadu shkolnij mis	потом на турпаке  школьный мыс
achin bichon edu mugdekon	не было пня
wadende	ты убьешь 
goworit nungan	говорит он
wasilij	василий
hodu gorodu utole umukon beje bultadena emukin girkudana erdelon ekun-mal jamadun buruso	давным-давно один человек когда охотился когда ходил один упал совсем в какую-то яму
kotorij dunde tala emenmuren ugilo ohiktakardi odan	земля которая осталась там наверху стала звездочками
guson	сказал
wot hagdandulaji ulditchengkin	до старости шила
ewande echew erakade	ничего я не это самое 
potomu chto eche huktille muntiki	потому что не побежал к нам
no enin   eninmun umukin mune angedechan i  	но наша мама одна нас это  
kan nungan ofkandingkin er nawehi nawehilwe	именно он велел делать навесы
dinngilegicho tepkedene nungardulatin	побежал ревя к ним
ehi hunmiktel nawalom	сейчас мошки навалом
w upor pektirochon	в упор он выстрелил
mikchanem uguchaktiki	спрыгнул к оленю
bi hine nodadingaw eregerit	я тебя совсем брошу
i obed ngenechelen nulgistew nulgistew wpered	и когда обед прошел начинали аргишить начинали аргишить вперед
bi ichedem ongokton bagdamacha belij polosa bagdama	я вижу у него нос побелел белая полоса
ni nekunmite achin bisonne	ни младшего не было
amtachan nungarwatin-ka	он почуял их
bi bangnem on brigadir bidem gunne	я отказываюсь говоря как буду бригадиром
nungan ngolepkonen nginakirwa	он испугал собак
ikoleptidi   uguchaktu tegetchene ikodene ngenedewki uguchak i doldim	я ехал сидя на на верховом олене и пел и услышал
umnekorte ekun emeren mutpe ewedit alagudaje	редко кто пришел нас по-эвенкийски научить
eninmi paka indechon dudu edu tozhe jerbekedu eninunmi ulguchematchengkiw	мама пока жила дома здесь в ербогачене с мамой разговаривала 
wot ehi ehaja asin odam wot teper	вот сейчас без глаза стала теперь
nu nawernoje birke	ну наверное
gramatew asin wse rawno ulgusoningnem tugu tugu tuge ajisingnem ororwo tugu tugu ongnokorwe baldiwungnerew gundene	грамоты у меня нет все равно рассказываю говоря так так так лечу оленей их так так телят выращиваю
ekun-ka uchastok hogdinga	этот участок большой
hawaldere	работают
ekun-da asin	ничего нет
potom wertolet degilchalan hurum neku neku dagin hukulediren	потом когда улетел вертолет я пошел рядом с лабазом лабазом лежит
wamulcha nginakinma heweki	бог рассердился на собаку 
chipkarwe wadechaw motilwa	соболей убивал лосей
nungartin chulugdil hegdimemel bichetin	они чулугды были огромными
olgisa-da taduk hele taringmi tadu lokoso ajamamat olgodon	высушил и потом-то ее повесил там чтобы хорошо высохла
hokoritte-da malij stado manawren oron	потеряли малое стадо олень закончился
ekura nikedengol odawer ngoldan tar sipkanngis	что делать 
bi hujukukon bichow togda	я маленькая была тогда
bi nunganman gunil   oril   	я ему стала   
edu ariren edu-ke pastukilkel gunne	сюда позвал сюда говоря пастуши
ekeldu emere eregerit gundene	не приходите никогда говорит
huruwsotin er ilkendenel hurure	увели делая зарубки пошли
ekun-mal-ta odan	что-то случилось
ulgurdam on hargiltiki shurungnerew eduk	расскажу как в лес уходим отсюда
menderkangaha bichon	покойный хромой был
amintin edelin emere taringilbi dajaran	пока их отец не пришел он их спрятал
du̅kakandiwer bichowun	у нас был маденький чумик
mindula ichetcheren	смотрит на меня
er-ke orone asin ewenki eton utolepti emti ine	ведь безоленный эвенк не смог раньше жить
zootehnik omi orodi hawalim diplommi upkatpa-na	зоотехником оленным став я отработала целиком свой диплом
bi-ke on nungardutin turatchem ewedit horokil	я-то как им скажу по-эвенкийски глухари 
poetomu esikotkon engeni bi engnem ajawre ekur-wel targachira	и сейчас я совсем не люблю что-либо подобное 
bejel ikolde	мужчины запели
i eto wot nungan uzhe zabila kak po plechi uzhe nachal prowaliwatsa etot wrag	и это вот он уже забыла как по плечи уже начал проваливаться этот враг
tarawer kojiwkotnel ororwe hi busilde bejeldu	заблуждались когда оленей людям раздавать стали
tar walektula duwupkil bichol unguno	в тот валек возили это самое
emere	пришли они
bi-ke bihem heweki	я-то бог
etirke̅n һangkeleje odapki nu wot i wso	муж санки делает ну вот и всё
er-ke urkewe angaldende	это самое вдруг двери откроет
zoowettehnikumme manam	зооветехникум закончила
wot tak bichow	вот так я жила
nulgiskot erkordi wot nulgiskot erkordi	давайте поедем на вот этих  на вот этих
esikotkon umukon wnukiw   armijala gara	сейчас один мой внук   в армию забрали
umno amingahaw hururen posoloktula	один раз отец покойный поехал в поселок
taduk hele tar hurusalan hargi tadu horoldeso dagi	а потом когда он ушел черт крутился там рядом
mewuicha bicho nungarwatin	он был на них очень рассержен
oj huktillen tozhe	ой побежала тоже
tadu bichetin kergentin hegdil bichetin	там были семьи их большие были
derewnadu ekun-da achin jablokel ekur-da achir	в деревне ничего ни яблок ничего не было
wot ajat indam w obschem	вот я хорошо живу в общем
emeren dulai	пришел домой
tar amakan gunderen  	дедушка сказал  
potomu chto nangmaktadu nungartin wek lezhat bojatsa komarow w les ne hodat redko nochju tolko oj dolbo tolko dolbo ngenepkil	потому что на комарах они век лежат боятся комаров в лес не ходят редко ночью только ой ночью ходят
eduk-de wek busselderes	теперь вы всегда будете болеть
i nginakir ekun-mal gogodere tadu ulledu	и собаки кого-то лают там на мясе
ange kalakachan bichon munngi taz	это котелок у нас был таз
nu i wse nu i eto ja goworu eto hodim na lizhah	ну и все ну и это я говорю это ходим на лыжах
bejunme nan eton tuk pektirore podrad	дикого оленя опять же он так не станет стрелять подряд
huteltin ketememe bisotin	детей у них было много
hogdokortin	хвостики у них
umukon huten	у него один ребенок
tar kungakandui bukokutcha	он умер ребенком
monin hawalildan	сам начал работать
bi gunilim ekel orere tadu angil angil ngonimil bunidere gunilim	я стала говорить не кричи там эти длинные воют стала говорить
uzhe haktirallan	уже стало темнеть
mundukare emewuwki	зайцев приносит
bu gunnorew	мы говорили наверное
tar hutelnunin bidewki tar beje	с его детьми этот человек
tar dulawer irektin ildewki	когда они заходят домой он заходит
hulukunduf ngenektesowun potaptula orordi	когда я была маленькая мы ездили в потапово на оленях
ami ohotnik bichon	отец был охотником
tadu zhe napugal oronmo	там же напугал оленя
ekunma orordi emeren	кто-то на оленях приехал
ama tar kak jego   	дедушка тот как его  
umukon gulewun tolko	один дом только
angi luchal kokoldoltin zhe	это самое рукавицы русских же
angil oror ngenedere	эти олени идут
nungartin ngenedepkil chuluk-chuluk-chuluk	они ходили чулук-чулук-чулук
bi-ke hagdisangehiji-ne ekun odam	старый стал что буду делать 
hawalkira hawalmnitin oran	работящий   стал у них работником
no ungunbele adelinaje huruwren	но он эту самую аделину свою повез
taduk er turula emewungkitin gurushshikil	потом это в туру привозили грузчики
ekun tawer gunderen	кто там говорит
hukewe bure hegdikokun	топор дали огромный
starajawe metrikawa bakachawun a   mohadu	cтарую метрику нашли в лесу
toli aja bich   aja toli	тогда хорошо  тогда  
hele mangi ahi kelter huktillen ilandi mangil bejeldi	вот медведица в другую сторону побежала с тремя медведями-самцами
mirenim	вышла замуж
tar sowhoztu bi hawalilchaw	в этом совхозе я стал работать
tar bejewe iseso tar degi-kinggit kinggit tare	того человека увидел эта птица кингит звенящий
w ochkah hodil wse wrema u nego spetsialnije takije ochki	в очках ходил все время у него специальные такие очки
hele hururew hururew ngelifsijoj ngelifsi	вот уйдем уйдем страшно страшно
taduk stadolatin nulgirewun	оттуда мы в стадо аргишили
hinngi opitis hegdi	у тебя опыт большой
danduk tunnga annganiw bison tadu	пятнадцать лет мне было
nunganman-mok-kon ewkil ejdere daran girkudariwa	совершенно не замечают его когда он ходит рядом
timatne alatten tirganiwe	наутро ждала целый день
upkachin ange gar achin eche degde ere bire jesli birekin tar mugdekon	всё гари не было если бы это был пень 
edu hargi girkudawki dagi	здесь черт ходит рядом
tozhe ilmakta bisof	я тоже молодая была
jesche epkit bichon	еще нельзя было
frontaduk iso	с фронта еще
no i nungun wnuchatilwi bihe	ну и шестеро внучат у меня есть
umukon kergendu orortin hjerdutin hunngtu ekurtin hamelkitin	в одной семье на ушах оленей одни эти самые отметка
changit tar changitpa tare angiwat choknagat	давай это самое пойдем убьем того медведя 
ganatmatchewkil	долго стрелялись
lusadit nungartin ere tare minduli jangure	по-русски они со мной не говорят
indemchel	жили бы
hele etejetchekel bejengilbew	давай сторожи моих людей
engkiw gorojo hawalda	не мог долго работать 
ganalchiltiki guso	стрелкам сказал 
haktiralcha uzhe	темнеть уже стало
nu umuken halgachichil	ну одноногие
ichem abachiwa	увидел медведя
angja okel gunen	это самое сделай она сказала
haktirila huruwki	она ходила в темноту
ilodo poka edoi hurure nekedam pensionerka	никуда уезжать не собираюсь пенсионерка
duktedutin ugranda tare	он сел на них двоих
iheldu ho biwki igin	на камнях был сильный шум
ja bi gunim ke esile kamana dawakat angilwar uchakilwe	я сказала давайте сейчас скорей поймаем этих учаков
tare wmestodun hawalchaw-da ter ispolnajuschim direktorom	вместо него я и работал тем исполняющим директором
eduk etende	отсюда ты уйдешь
hawal idu-de echew hawaldara	нигде не работаю
kungakanduji bi tuksektadaji ekengkif ewideji ahatkarnun	в детстве я побегать хотела поиграть с девочками
ilo bolshe odere	куда еще денутся
sowhoztu sdawangkin	в совхоз сдавал
potom bakaran umukon kergenma huteja asir	потом нашел одну семью бездетную
tarildi dolboni tirgani gurusipkil burdukalwo ustawan-te	с ними ночь день грузили муку все подряд
umno huruso bejetkon tare	один раз пошел этот мальчик
angilwe bagdakelwe wadakilwer tare debdere	диких оленей убив едят
taduk bi doldim	потом я услышала
tunnga annganiw minngiw asin bison	пяти лет мне не было
i toli doldillew doldirew	тогда мы услышали услышали
ngenedeso	шел
sipkanme dengkewa gogodaran	соболя соболя лает
no potom gunderen ngeletchepkil judawer tuliski	но потом говорит боятся выходить на улицу
nu taduk okildewe tam ilaldawo wsego nulgichowun darkinduwain	ну оттуда сколько дней там три дня всего аргишили по хорошему насту
gune-ke ehikon chiktil ketememe onotolis	говорила что сейчас бисера очень много только бы заниматься
taduk nungan icheren hegdikorwa angi   halgarwe	потом он увидел большие ноги 
jehelduk chirindalduk bajkisilduk hirulwe menajingkiwun	из ессея из чиринды из байкита меняли быков
ami dalshe huru chaski huruden mohawe chaski	отец дальше поедет в лес дальше
potom uzhe ilitin tirgani hururen	потом уже третий день пошел
eningehew chatipkalden-da i ulgusolden	мать покойная чаем напоила и рассказала
ekel duktere	не бей
urkewa angasildende	двери начнет открывать
tadu bejur togda ugduhichel bichetin	туда дикие олени тогда залезли
nu menngilduk dunnelduk gangkitin tar ewenkil antil erupchut indechatin	ну со своих земель брали те эвенки которые плохо жили
bu orolorwun defkittikiwun	оленеводам нашим наши продукты 
nu tolko durwe hami nimngakar	ну только две знаю сказки
nungartin ngelle	они испугались
zherdi ange zherdilwe tar molwe notte gde u nego amngan	жерди палки разложили где у него вход
bi gunim	я подумала
doldiren chulugdi emedere	услышал чулугды приходят
tug oronmi irgidefki-to oronmi irgiwdon koroppan menat nado hirulwe menattengat	так оленя воспитывают чтобы оленя воспитывать важенок менять надо быков менять будем
i icherew tadu aminmun ororin uchakilin tegetchere	и увидели там олени учаки нашего отца лежат 
kungakan tarin luhu baldidana hanguktawki	ребенок этот все время пока рос спрашивал
girkundakal idu-de guse	гуляй повсюду сказал
tala nawernoje birke	там  наверное был
umukonme mangiwa ahadere nungun binel ahiwa mangiwa	одного медведя гонят вшестером медведицу
mortin isette hoktewer	сами смотрели дорогу свою
bagdakele ichetnehinem	поехал диких смотреть
hutelin tadu bidewkil	его дети там были
nadaldawe nulgichowun kun   tala	семь дней аргишили потом
no wso rawno upkat uzhe pochti luchadit upkat hengketchepkil	но все равно уже все почти по-русски говорят
shura nu	шура да
tari tar tadu du̅tarawun inerewun	вот там пожили в чуме побыли
ebej beje ekel ngelifse bidegin	ах человек не надо страшно пусть будет
ela nungarwatin nodam	куда я их дену
nungan gunen	он говорит
hele ewiwunewer odam	вот игрушку сделаю
minngi amim bison gerbin dada ewedi gerbin dada	моего отца звали дада  эвенкийское имя дада
hajale tala nginakir goshajadu	нет там собак у гоши
bri brizgewettere	брызгают они
guso tar hutelwon	сказал он детям
bi nan tuksasinem karabindulai	я опять побежал к карабину
ilan tirganil ngenechalatin emeren	когда прошло три дня пришла
a to huwer ribakil bichol ere amingahaste	а то вы были рыбаки этот отец твой покойный
dapkidui hurusow dapkun annganidu	на восьмом пошел в восемь лет
potom potaptuk nungarnuntin emehilderew	потом из потапова с ними стали ехать 
bumulifkil oror hingnene	умирающие олени жалко очень
gune	они сказали
dunnela burum	я упала на землю
dur hutesi etirkosi hawaldaran tadu	с двумя детьми замужняя работает она там
menmaktel irgektel ororwo-ke kikchafkil	комары пауты оленей-то кусают
murukedawki amutwa murukedawki	кружил кружил вокруг озера
a bi hele amaski muchuwohindem hele uldengilwan uldelwo	а я вот назад отвожу мясо принадлежащее ему мясо
ih nikak echew albaraw dawadami	так их никак не не смогли мы поймать
mom elo hele emesow	сам сюда вот приехал
nu ulguchondem	ну расскажу
taduk ele tar ekonem nawkane amakan lukilwen hele perem olcha ajamamale	потом вот не попав дедушка стал делать настоящие стрелы очень хорошие
eduk etem hindi girkitare	другом тебя больше не буду считать
etejetchengkin amingehe	покойный отец сторожил
kenggilortin kenggilorin doldim	их колокольчики его колокольчики услышала
emere-de udalin	приехали по следу
potom delkendui ejewel gadai tuktiso biso	потом на лабаз что-то взять залез
togda warak gundene	тогда враг говорит
hutelwi dewdotin tar dugudewki biso tar kinggit	тот кингит приносил детям поесть
a oror tozhe ngelelchel bipkil	олени тоже испуганные были
tolgokiduktepi jum ami noguju uitchenman poka	я вышла из своих санок пока отец привязывал передового оленя
pustire nunganman	отпустили его
ilda	встали
mesto aja tozhe	место хорошее тоже
amakatkanme hujukukonme dawudechatin	они поймали маленького медвежонка
ere ganalchil emesoldo	вот стрелки пришли
edin hukugicho nungarigitin	ветер стал отворачиваться от них
ekur ilkendekisiltin	чьи это зарубки
ahal nadan tolgokitin bifkil bejelngil danduk dure danduk ilan binel	у женщин семь саней грузовых было у мужчин двенадцать тринадцать было
eja-wel ekungan binoro gundene nikoso	кто откуда могут быть вот он говорит
choknastew changittula	пошли убивать к медведю
ertiki amutkan hegdinge ichebdepki	туда озеро большое виднеется
huliwun odan	все стало
tar beje jangu jangurakin togotin hingkewki biso   hingkeridewki	когда тот человек говорит у них трещит огонь
tunnga metrit taringitin burucho bicho	в пяти метрах он упал
taduk haman tegeren	потом шаман сел
sura bichon	шура была
horosho  	хорошо  
ilkendulitin hurukel	иди по их зарубкам
beje beje girkin odangas	будешь другом человека
ojin hariktalcha	над ним начал парить
mola mola 	дров дров 
toli edu bison sowhoz	тогда здесь был совхоз
hatanawa er guso elewel bingnedere gundene	черта этого говорит какие-то бывают
bi kungakan toli aminmi luhu beledengkif	я ребенок тогда отцу своему всегда помогал
dadaw jokellen	дядя закричал
eninngeheji bi ajat donchadam	мать свою покойную я хорошо помню
tak arkichatin ehawew tar	так они проткнули тот мой глаз
eterew eregerit eduk isewulde	с этих пор никогда не станем показываться на глаза 
hutelin oda	у него появились дети
bi chok   chokchaw bah nunganman	я прицелился бах его
tarin hekergeso-do amargildii ilkonem ere ikonmon tugilwer ustawan kahiliwki	тот рассердился и встав на задние лапы вот так всю грудь ему порвал
dukchaduwer tegetchenel tar depdenel gusol	когда они сидели у себя в чуме и ели они сказали
dengilbi biwuk bingkitin mundu ugot	деньги у нас всегда были
uholchon	заболел
aminin hirogir dmitrij aminin udigir walentina trofimowna	отец ее хирогир дмитрий мать удыгир валентина трофимовна
e tadu norәw nunganman	там мы похоронили его
turudu uchitchaw	в туре учился
diktele ekurwa ahaktadangkif ulgukilwe ulgukilwe	за ягодой за этим гоняла бурундуков бурундуков
isetcha-da gunderen	увидев говорит
on oda	что с ними стало
taritper ngolesilden	вот этого она станет бояться
postojanno gramotalwa bungkitin nungandun	постоянно ему грамоты давали
emonmuchotin guleldu	они остались в поселке
tara bi doningnem	это я вспоминаю
hululan ho kungakan	маленький очень ребенок
tug nikochon bimche	так делала бы она если бы была
tare tarilba ugadana hururen erdelon tar dulduktin	совсем ушел от их чумов неся эти 
bi inekteldem	я смеюсь
ungunduk angil dalin angiduk gulelduk emere-de iseno angila	родственники из этого из поселка приехали и поехали посмотреть
brigadir okel	будь бригадиром
i tegemile bidechow	и до следующего дня был
tuliski juwki-da tar beje	этот человек выходит на улицу
dewuldektin dewudeliwki ostolduktin	когда они начинают есть он начинает есть с их стола
umukin emenmum bi umukin	я один остался один
minngi omolgilwi e dalwi towlohine gospodi	мои сыновья ой мои родственники поехали по ягоду господи
angirawun obradowalis w obschem chto obradowalis chto oror mutki emechel dulawer obratno	обрадовались это что олени наши пришли домой обратно
e ngelelle	о испугались
gewran toktohinen ongoktolin kotot	он повторил ударил по носу пальмой
nu digilrewe hawalingnem nu duleshki digilrewe amashki	ну четыре дня хожу ну вперед четыре дня назад
tug-do node dulai ihim	так-то хорошо доехала домой
epki eto kahirgare nu i ladno etirgare to jest	не ломается то есть не рвется
wiboril bulleterwe ngenewungkiwun	на выборы мы бюллетени привозили
bi durwe tadu horokilwe wame	я двух там глухарей убил
urkeje edelikonmi angare burupki	не успев открыть дверь упал
uldekokurwe dewdere	мясо едят
ngolepkosilde	стали пугать
ilmakta hawalilchaw	молодая начала работать
taringilnum bidedengos	ты будешь с этими моими 
ami aminun hururew ohotnikildula aha	отец с отцом мы пошли к охотникам ага
ilmaktadui dadanunmi ohotilsadichaw	в молодости я охотился со своим дядей
do sih por do starosti bichon ehan ne widel	до сих пор до старости был глаз у него не видел
abachi uluren tiparawa i tipallan ongoktowi hokse edon ojone	медведь откопал грязь и стал мазать свой нос чтобы не текла кровь
bi albahichaw ildami	я не мог встать 
aminduf kete oron bison	у моего отца было много оленей
edu motimidichow bejure	здесь охотился на диких оленей
tug-do ese nawkane	так и не попал
taduk nungan gunen	потом он сказал
sadiktu hawalchaw tozhe	я работала в детском саду тоже
tadu indere ajamamat gunne gunne hehenen	сказал там живут очень хорошо рассказал
taduk tuksahinen amana	потом побежал быстрее
bi nanchisilchaw hine	я стала тебя нянчить
nu bu sururew tala	ну мы поехали туда
kete bichetin omolgil kete hunatil bichetin asatkar	много было сыновей много дочерей было девушек
erupchut inchowun amaski hot	плохо жили раньше
amim tolgokiwa oran hurupdoi eninmef dundengdulon i edu nodoi	отец санки сделал чтобы увезти мать на ее землю и здесь похоронить
biraldu hindatchaw delilwe nirusarwe majgulwe	на реке рыбачу тайменя хариусов линков
mu odan tadu	там появилась вода
tar-da huruwupkil danduk duldo kilo digin namate ki kilometr helekemet	везли двенадцать дней четыреста километров с лишним
nu amaskite jesche ororrikteldi zhe girkungkitinte	ну раньше же еще на оленях только же ездили-то
magazindu sdajchawun ollolwo ullelwe chipkarwe	сдали в магазин мясо рыбу соболей
angil bejel angiltin igiltin doldiwra	это голоса людей слышны
gil ewen   iduk iduk eni bichen nungartin bichetin bolshoj porogtuk amintin nungartin pankagirskajduk rodtuk bichetin	откуда откуда мать была они были с большого порога отец их они из рода панкагиров были
nungartin akchulla daldulawer	они стали рваться к своим товарищам
dinngilecho gde-to derelotin tadu	он бежал там им навстречу 
bi bi uchakki dawamalcham taduk	я своего учака быстро поймала потом
dezhuritde   dezhuridepkil kungakar dolboniwe	дежурят дети всю ночь
prishlos ngenedemit	пришлось пешком идти
hukitei garan-da buren editkii	живот свой взяла и дала мужу
eton-nun erupchut ora	он не будет делать плохо
homotiwa umukon raz wame	медведя один раз убил
internattu tak-to bidengkiw	я так-то в интернате жила
nungan zhe girkuren	он же ходил
emedengnewun	мы приходим  
omonim tegemile	оставил до следующего дня
wot tundra prawdu	вот тундра правду
potom wertoletit degrewun	потом мы вертолетом прилетели
bu u   utele ewenkilwe   utele ewenkil ahijawar gengkitin hungtulduk dunnelduk hungtulduk dunnelduk	мы раньше эвенки жену брали из других земель из других земель
a ungundu tawar walektu ehi er walek biden tadu angipkil bichol ororwer dawuchapkil bichol	а там этот самый в вальке сейчас этот валек будет там это самое делали оленей держали
jescho dagamawat	давай еще приблизимся
hama hamahaldu	хама хамахалду
ichetcheren	видит
ohotnikil aha ekundi emerkel ne pomnu	охотники ага на чем приехали наверное не помню
bure nungandun tandan	дали ему закурить 
tut na dimokur olenam taskajem	тут на дымокур оленям таскаем
guleldu tam oki tri ilaldawa bichowun	в поселке там сколько три три дня мы были
edu pohoronen hukuloderen	здесь похоронен лежит
ranshe won towlidei ajawungkiw pramo	раньше вон я прямо любила собирать ягоду
namadiwe toli wachal	сотни тогда убили
tar gurustu girkudaril	те кто с грузом ходили
emerew	приехали
tuksadedawer dildan    dildandadawer	лишь бы побегать повоображать
horokila pektirondengos helakila emi gune helakila	глухарей стрельнешь куропаток – не говоря уж о куропатках
dada gunen	дядя сказал
i wse rawno on-mer kedene popallen nungardutin	и все равно как-то попался к ним
idi chaski okel diski diski amngaduk diski okel	в стороне будь подальше подальше от входа подальше будь
obiknowennaja nu	обыкновенная ну 
horoshaja babka bichon	хорошая бабка была
nungan tegetchechen edinunmi	она сидела с мужем
kungakar hajale duduwer	детей нет в чуме
dur hutei edudo baldildigasan	двоих детей она здесь с ним родила
tegetcheren	сидит
jesli kungakan kutusi kungakan kutusi bihikin ororin baldilifkil	если ребенок счасливый если ребенок счастливый олени его растут
tozhe nimngakanli ekunli	тоже сказка ли или что ли
baldicha bihim	родилась
wospitiwat-to one	воспитывать-то как
nu i huktidere	ну и бегут
produktow malo gachawun produktelwe	продуктов мало взяли
aminduf haman guso	отцу шаман сказал
tar umukon angani nungandun bisow-do elo otpuskalai emem	в один год я у него был сюда в отпуск приехал
aminmi gerbin bison udigir innokentij nikolajewich	моего отца звали удыгир иннокентий николаевич
muttuk heleket indere tar hergudu dundedu	они на этой нижней земле живут лучше нас
nu gorowo eson hawalda tar kazah kazahstanilduk emeso	ну долго не работал тот казах из казахстана приехавший
potomu chto ilmaktal bichotin sami nginakir	потому что были самые молодые собаки
i mine gune	и мне сказали
heweki-te gunen	бог-то сказал
tewlahidechawun eto dur annganil	мы ходили по ягоду два года 
ekunnun	с кем
nu tug gunderen	ну так говорит
dulindutin dukchal ischende-do isettoi tar hegdimomowetin duwa-do	ты дойдешь до середины чумов чтобы увидеть этот огромный чум
dinngilehinchicho	он побежал
i ilo-do ngenedengos orondi	хоть куда доедешь оленем
nungartin guningkitin chipicha kinggit	они говорили птица кингит
heki erdelon tar ilitcheren pehisiwso	эта большая лиственница до сих пор стоит расколотая
tuge tuge tala molwe nokellu tala	так так туда палки положите туда
a akim erupchut indeson tadu	а мой старший брат плохо жил там
horoliktedecha bicho	крутился
ngelewsiko hegdimama hegdimama bichon	очень страшный большой-большой был
tozhe motimidichow huksinun mart dulindun	тоже охотился на лыжах в середине марта
jangildu biwki biso tar iheldu	на горах бывал был на камнях
dan klasspe manachaw	десять классов закончила
ahal-da e-ne hawaldafkil	женщины тоже это работали
tar beje jangudariwan gundere tar togo hin    togot hingkerideren	про то как разговаривает этот человек они говорит наш огонь трещит
i uldengilwan dowuldedem	и мясо принадлежащее ему стану перевозить
sindu okin anganis bichen	тебе сколько лет было
oron ewenkidu elede hegdi belego	олень для эвенка все-таки большой помощник
taduk hurusolon tare umukon emeson	потом когда он ушел  тот один пришел
ilan anganisil binel kungakar asir ongkitin ulguchonmochilchol bi   binel	будучи трехлетними начав разговаривать дети умирали
aga nu bolo-te nginakirdi	ага ну осенью-то с собаками
kinggit hutelin-to tar jonmasilchal	дети-то кингита очень испугались
aha urkewatin angamda perchatkelwe ichem tug harbaldedere	ага их дверь я открыла и перчатки увидела вот так растопыриваются
targit emechol bichotin tozhe	оттуда тоже они приехали
okir bi tepkelim-de taduk taril himurgara 	когда я крикнула все затихло 
tugdo bi duloski huktiwuhinem	так-то я вперед поскакала
pramo dumala bejeje etem bakara	прямо думала мужчину не найду
angidu dolboltono istan	это вечером доехал
i nungan tegeren	и он сел
potom taduk bi wertoletit әla әmәhinәm	потом я на вертолете сюда прилетела
i to jesche angi utunilipki dola nawernoje utunilirgun	и то еще это самое чешется наверное внутри чешется
echol bihiwun hare	мы не знали
nurmachal	подкрались
aminngahaw angilcha logilcho gunne	отец покойный это начал ругаться стал сказав
a etirkom gunden	а мой муж говорит
bi dedushka   oj amakanun aminun-he bi nulgisinim	я с дедушкой с отцом аргишила
haman hamanildan	шаман начал шаманить
tar emcha	это бы сделали
archemkachalde mune һaja̅le amandichal	встречали нас но не было опоздали
achin achin	нет нет 
taduk umukondu diski huruchowun tartiki alik stadola	оттуда вместе в лес поехали туда в стадо алика
ewkil nunganman isere taringilin ewkil ejdere-de	его не видят и не замечают
tala buran emekteche holkit	там буран приезжал недавно
orolo   oromilowun tadu tiremticho bicho	наших оленей он давил там
i tolinge budan uchamidu	и тотчас умер в учами
na̅demachawun orokorwe gde-to dapkutalwa-hinche	получили в подарок оленей где-то по восемь голов
debngenelwer debdere tare ngonimil	свои объедки едят эти длинные
i dolboltono tegetcheren	и вечером сидит
nungarngitin udaltin achir	следов их нет
da da	да да
nungartin muchuchal dukchalawer emechel ororwun ororin tare nunganngilin	они вернулись к чумовищу пришли наши олени олени эти его
tozhe uchakki pustim bi menngiwi	я тоже отпустила своего учака
taduk angilbi ororbi ilda	потом мои эти олени встали
heweki hele angilba odawki	бог-то этих самых делает
hele bi ere mot ange bejngo ireksewon olgikta	вот я это палкой высушу шкуру дикого оленя
dawaj dundewe hogintugat	давай землю пинать
daldui hehendengow	друзьям расскажу
goro bicho tadu stadotin namadi da̅n kilometr potaptuk	далеко было там их стадо сто десять километров от потапова
tolko shkolalduk huruche	только из школы ушел
aminduwer enel hilbara	не говорите своему отцу
ke gunem jakut golomowon bakam	вот сказал я я нашел зимний чум якута
keshaw baldiren	кеша мой родился
digali	на дигали
ewkil-da mine isehine	не смотрят на меня
edukwehin etende ekunmada bakara ilada hurure	отсюда ничего не найдешь никуда не уйдешь
amtilwi emere gunmi tar aminmi umne hehenchan minduju on elo emere er dundilo agataduk	родители мои приехали так сказать отец мой однажды рассказал мне как сюда приехали на эту землю из агаты
chagit togda dawakal ngaleldiwi	подальше тогда схватись руками
deptileletin emepdere	продукты привозят
nungartinkun nurmachal ajamamat ichetchechol	они-то подкрались хорошенько смотрели
bultadengos dewdoji bejngoje bejune	добудешь поесть дикого оленя дикого оленя
potaptula tarilduk girkudengnerewun	в потапово от них ездили
tarawe hele tar guso nginakinma	потом вот он сказал собаке
bi eli baldisaw	я здесь родился
hawaldapkin oldachan-ke	стал-то работать
ehi bedni nungarduktin eleduktin inderen ungun ele gala a samaja mladshaja	сейчас бедные из них из всех живет эта вот галя а самая младшая
hele duktemkoren-do hutelin jonmasilchal	вот он стал колотить и дети очень испугались
gugaretchere	звенят гугарой 
ewanda echew ichette	ничего у нее не посмотрел
eche horosho eche huktille mune ahahine	хорошо не побежал за нами вдогонку
taduk elo emengnerew	потом сюда приходим
wot tarbawa anganiwe inchen minngi ebekef	вот столько лет жила моя бабушка
on-ke nikeldere	что же они будут делать
taduk amim emeren	потом отец приехал
jullen	начал выходить
ororwun manawra	наши олени закончились
kungakan amakan-te etirkon inde   ilani enitin	ребенок и дедушка-старик и мать трое
muje gelektenehinen	пошел за водой
nu gunderen widno ilane tirganil hiranipkil ange makitkar odatin	ну говорит видно три дня спариваются чтобы были медвежата
nungan ekun bison turuhanskadu	она это была в туруханске
ngalelwe hongnasal	руки отрезали
suglan oran-da gune elo ele- ele- elet emegot umundu bid bida bidep bigot	суглан сделал говоря сюда все давайте придем все вместе здесь будем давайте будем
opat hururen	опять пошел
bi ehikon ulguchondim eningeheji udigir natalja jakowlewnawa	я сейчас расскажу о своей покойной матери удыгир наталье яковлевне
er amakan guso	дедушка сказал
dulatin ikonemil gusol	когда пришли в их чум они сказали
hongnanekekor lokotchol tuge	отрезав же повесили так
bi bultadam biraldu digali chikti dami	я охочусь на реках дигали чикты дями
hine mozhet beledem	может помогу тебе
potom nungunme hutew baldim	потом шестерых детей родила
iledit	по-эвенкийски
satiralba isel-do bagdamalba lokotchol tadu	белых песцов выделали и развесили
bururen jolki	упал ёлки
a akim biwuk erupchut inderen	а брат всё еще плохо живет
potom	потом  
aja ahi bison	хорошая женщина была
