kok rush udyr-shamych ulyt yle	две русские девушки были
wara malyzhe	пусть поспит
ere kolysho imnetlan da mo da pesh shortynam da	плакала из-за павшей лошади и прочего
myj kuznechysh koshtynam	она не отсюда потому что
izirak ergymyn kok   ik ergyzhe ulo	а у младшего один сын
tu   pyrlak ik kechak kajenut	они все вместе в один день ушли
wara adak	потом снова
tylanet tyge chuchyn	тебе так казалось
tushto joltash-shamych shurat	там же друзья мои боронят
tudo budkysh petyrenyt	закрыли в эту будку
mylam trojkym shyndysh	мне тройку поставил
melnam kuze yshtash	как делать блины
wet izish ilynet dyk	если хочешь немножко пожить
hot w tserkwu hodi nikto ne zapreschajet tolko molis	хоть в церковь ходи никто не запрещает только молись
moshtash moshtet konga uke gyn wot kanyl ogyl	может сможешь но если нет печки тогда нелегко
trotuar den kajena chyla lawyra	по тротуару идём везде грязь
myj shym ijash mo	я в семь лет что ли
adak tselinashket shyna kaj	опять на целину не поехали
ala iktazh peche jymak	может под забором
wot	вот
sergej wasiljewich	сергей васильевич
tynar shinchawudsho jogen da kylmen shinchyn jushtyshtet	столько слёз она пролила и слёзы заледенели в морозе
postaratsa da kulesh konechno zhe	постараться конечно нужно
tudym kindysh pyshtena yle	их добавляли в хлеб
no tora welyshte ulytat	но они далеко живут 
pokrywalym pidme yle mo ustembal	покрывало связала это скатерть
oj washport kuze lijesh	ой как сказать вашпӧрт 
dwa   dwa doma postroili shesteryh detej sdelali	два   два дома построили шестерых детей родили
kol kandashymshe awgust tide spas memnan	двадцать восьмое августа это у нас спас
juzhgunam zhe ojlat chto tyge   jesli	иногда же говорят что так если
kolen koltysh shoryn shysh kert da	умерла не могла ходить в туалет
ajda portylyna mo memnan imne lijyn	давай вернёмся что случилось с нашей лошадью
tyj	ты 
nuno kolhozyshto shke kushko kulesh	они в колхозе сами куда нужно
kandash ijash ergyzhe yle manesh	у него был сын восьми лет
mo kok gana ojlenut mo mom yshtenut   jenym shortarenut	два раза передавали заставили людей плакать
ulo mom sharnaltash	есть что вспомнить
chaple imnym shogalten kodyshym mom yshtet	хорошую лошадь оставила что поделаешь
kudlo kud ij ilem	шестьдесят шесть лет живу
marijzhymat	и по-марийски-то
ik ijlan sajyn pasham yshten ot kert	ни одного года не можешь поработать по-хорошему
nu ilena uzhyna	ну поживем увидим
tuge no	ну да
tun dech warazhe ere en ere pel jolem korshtysh yndyzhe kogynek korshta	после этого одно нога начала болеть а теперь обе болят
i kinoapparat ok kul 	и киноаппарат не нужен
a bliny eti gotowili	а блины эти готовили
udyramashyzhyn wara mozho poryzhsho yle	у женщины был этот любовник
operatsija o	проведём операцию о
mom yshtash kulesh yle wet urawnenijym	это надо было делать ведь уравнение…
tudyn dech wara konechno zhapshat ik ij uzhe ert pochti chto ik ij kajen dyk	после этого конечно прошло уже около года
kalasen kertam	могу рассказать
kidsherym kuchysh da	пощупала пульс и сказала
galazhe yle	галя была
naprimer telewizor radio muzykym kolyshtyt magnitofonym diskotekysh koshtyt	например телевизор радио музыку слушают магнитофон на дискотеки ходят
a   a u mena sejchas d jegorjewskim doch-to zhiwot dak	а   а у меня сейчас в егорьевске дочь-то живёт
trudodna yle ere	всегда были трудодни
mo nyngajenut	что увезли
cherez desat let wed da	через десять лет ведь да
kom	этого
natalja aleksejewna kok gana kalasen	наталья алексеевна два раза так говорила
ko-ko tyshte mom yshten	кто здесь что делал
tudo tudyzho	она она-то
wara m miklajym yshtymongyzhe myj wara rabotajen omyl miklajym tushan yshtenam patdesat tretij go e-e patdesat tretij godyshto  	после рождения миклая я потом не работала миклая там родила в пятьдесят третьем э-э в пятьдесят третьем году…
shala pasham yshtyshym	работала разнорабочей
kalaskale chyla	расскажи всё
stipendijym	стипендию
a puja lumzho	а название пруда
jusho lektyn wara rastratym yshten	пьяный растрату сделал ушёл
oba	оба
me ozhno wet pogena yle makulaturym metallolomym wot	мы ведь раньше собирали макулатуру металлолом…
ushkalym   ushkalym uzhalysht da	корову… корову продали и
wara wo wojna tynalyn	война началась
zina kuwa koktyn jastarat	зина вдвоём разгружают
achatshyn	у отца
korma nangajashet	корма возить
u nas toktajbelake-to dak net ne strojat dak zachem-to	у нас в токтайбеляке-то не строят почему-то
luktat da	да когда вынимаешь
upym chylanyshtyn turedynyt	волосы у всех постригли
kozho sena sorewnowanij semyn	кто победит как на соревнованиях
tygezhe myner jolash	холщовые штаны
peshyzhe tyge nugydo ynzhe lij wishkydyrakak lijesh	чтобы не было густым пожиже было
kowaj tumna tum-tumym ojlo	бабушка сова тум-тум расскажи
pro shkolu ona rasskazala uzhe	про школу она рассказала уже
kochkash pukshat yle	кормили
tushko porsyn jolwam kuchenam myj	туда шёлковую бахрому приделала я
myj dekem rywyzh tolesh da 	ко мне лиса приходит
ja jescho wopros pridumala	я ещё вопрос придумала
nunat tygak rabotajat	и они так же работают
pujto tudo	будто она
i tushechyn myj wosht kajena yle jolyn polewaja uremyshke	и оттуда мы шли пешком на улицу полевая
logarzhe pualyn yle chaj	горло распухло
nu pokazhi wso sudit budut chto li mena	ну покажи всё судить будут что ли меня
eto skolko otsuda kilometrow	это сколько отсюда километров
e-e  	э-э  
sprosite pro radio kak eto bylo	спросите про радио как это было
kunar uzhat uzhat a to yshtyktet gyn ala jorshyn sokyr lijat manyt	сколько видишь видишь а если сделаешь  может совсем ослепнешь
tide toran jalzhym	дрянная деревня
ja zapisala	я записала
tunam marla kutyra	тогда он говорил по-марийски
myjetym wik kongambak pyshtenut kudashdeakshe	меня сразу на печку положили не раздев
tushto pesh chot kalyk wuchenyt oloryshtet	там очень много людей ждало в олорах
tynar ilenat da maje	столько прожила и
oj moshko kupsola aj kushko kupsola ogyl	ой в это в купсолу
kuwa deke mija	подходит к бабке
tuwyr-showyrem yle eshe wara tyshte jalyshtyzhe	тувыр-шовыр был ещё у меня здесь в деревне
cho	чё
jocha-shamychat koshtyn ogytyl	и дети не ходили
e eshe	ещё
nu wot tochno	ну вот точно
mo den yshtenda chernilazhym	из чего делали чернила
jatyr were pundysh turlo kashka pyrna-wlak kijyltynyt	во многих местах валялись пни разные коряги бревна и пни
prekrasno	прекрасно
uchitel-shamychym om sharne	учителей не помню
tushechak tunal da tunemmet nergen marlan kajymet nergen kuze acham dene	отсюда начинай и про учёбу про то как вышла замуж как с папой
tyj dwesti sorok den kolen otyl eshe manesh	а ты с 240 ещё не умерла говорит
wo wolodan wate	жена володи
oj kozhen kodat dyk trahomalan osobenno	ой шороху давали из-за трахомы особенно
lijesh 	можно наверное
a tunam jalyshtyzhe ko tyshte en perwyj telewizorzho kon lijyn yle	а тогда в деревне у кого здесь первый телевизор у кого был
eto uzhe tretij dom	это уже третий дом
idym	гумно
hota shkenzhynat chijen wozashat uke yle	хотя ей самой не в чем было лечь в гроб
ik kolhozyn predsedatelzhe	председатель первого колхоза
peshak rabotajman	надо много работать
a tudyn lumzho ulmazhyn wedasi	а её звали федосья
tol shynde shyndenut da kondenut	посадили и привезли
pesh obizhajenut da	очень обижали
wara imnym puat yle	потом лошадь давали
me prostynet dene chyla shkenam putyralynna	мы все завернулись в белые простыни
tudyn jydalyshkyzhe pizhyn shinchen	прилип к ее лаптям
pomirishsa i tomu procheje	помиришься и всякое такое
e wara sorykan tuwyr	э потом платье сорыкан 
jadykbelak kuwarym ertyshna	прошли ядыкбелякский мост
swojo	своё
posna ilen onal	отдельно не жили
kuchedalash pizhynyt	начали драться
kok shagat zhap gychyn mongo welysh oshkylych	и через два часа отправились домой
pawyl den kelshen onal	с павлом мы не дружили
kon lomyzh -	щелок зола -
a achazhe wara semdesat wosmojyshto kolysh	а отец в семьдесят восьмом умер
letom desatogo ijuna	летом десятого июня
tudym myj tozhe izishak shonaltenam tak	об этом я тоже немного подумал
nu zhit-to zhili	ну жить-то жили
kredalyt ala-mo	то ли дерутся
wich keche kanysh imne	пять дней отдохнула лошадь
tide shincha	оно стоит
tyge gde-to	так где-то
i wiktyr afanasich yle	и виктыр афанасич был
pujalan tudyn lumzhym puash manyn	того имя дать пруду
wetapteka	ветаптека
i tolynna wara tyshket	и приехали потом сюда
kok shagat zhapyshte pel wedra nare kolym kuchen shuktysht	за два часа поймали полведра рыбы
tugezhe it yshte	так не делай
kunar uzhat uzhat kolymeshket ile manynut	сколько видишь видишь живи до смерти сказали
myjyn kudlo kechym kudaltysht	и у меня вычли шестьдесят
em pesh kaja yle	лекарство хорошо шло
wot tyj eshe ko gala bolshe uke	вот ты и ещё кто больше нет
nawerno uzhe shongyrak lijyna	наверное уже старее будем
kok ij ushkal den yshtenam tyshte	два года с коровами работала здесь
chas eto pechki-to netu	сейчас это печки-то нет
tyj kojdymo lijat	станешь невидимым
nuno shu sutlanash   sutlanash ysht tunal	они не стали жадничать
kechywal dech wararak	после обеда
oj moroz	ой мороз
ana kajen sibiryshke	анна уезжала в сибирь
myj wuden koshtam yle	я водила её за поводок
kolkozet pua yle latkok kilo lozhashym	колхоз выдавал двадцать кило муки
ilenna	жили
tyshtyzhe mo	тут-то что…
tuge ludynam	так испугалась
shym ijash shinchash kajenam shuwylakyshke	семь лет на посиделки пошла в шуйбеляк
wara sorok chetwortyj godyshto	потом в сорок четвёртом году
ala-kuze udyrzho osal yle peshak	как другую… очень строгая была
kok gana koltenut mom	два раза передавали
e-e	э-э
kugu pajrem lijesh	будет большой праздник
tushto myjyn zina joltash udyremet pesh pidesh yle	там моя подруга зина много вязала
kok surtym yshtenna	два дома построили
eto kusnoj wed	это вкусно ведь
plushki delali pechenja delali	плюшки делали печенья делали
ik klassnyj wel yle	была только одна классная 
nuno drozhzhizhym pyshten ogytyl	но они дрожжи не клали
peshak jushto	очень холодно
a okazywajetsa	а оказывается
sheshkymyt mijenyt	сноха ходила
no ojlat chto	что говорят что
dak wed ne wse winowaty tam	так ведь не все виноваты там
manam no sajzhym uzhyn omyl jorshyn	говорю же ничего хорошего я не видела
tuaram	творожник
ruen kochkash towaret uke	срубить топора у тебя нет
pesh shuko shinchawudem jogen myjyn	очень много слёз пролила я
tak pritopami pritopami	так притопами притопами
posle wojny wot w pesat wtorom godu	после войны вот в пятьдесят втором году
no myjyn tide zhapyshte kajashyzhe	но у меня в это время
kuze pyrla modyn woshtylynna	как вместе играли-смеялись
wara pe patdesat wosmojyshtet	потом в пятьдесят восьмом
potom razwelis	потом развелись
nylde	сорок
kandashe eshe lijesh	восемь ещё может быть
meshakym kotomkatym da mo purta ulmazhyn	начал таскать мешки котомки и прочее
kuchen kertynam eshe	смогла ещё удержать
wy ne wozrazhajete	вы не возражаете
prostite	простите
nu	ну
nyl tuzhemlan nalynna kostimyt dechyn nyl tuzhemlanak uzhalenna	за четыре тысячи купили у кости дом за четыре тысячи же продали
a klassyshte tunemynna me kumlo jen utla	а в классе нас училось больше тридцати человек
no kuze manyt	как же назывется
pidam yle	вязала
toshto torjal jal kuze lijyn	как возникла деревня старый торъял
erla zhap ulo rusharnan	завтра время будет в воскресенье
myjzhe manesh wojenkomatyshte ulshym wel onchena kyzytshe	я говорит сейчас только тех кто в военкомате осматриваю
no   wara	ну потом
i to iktyzhym	и то одну
adak jocha-wlakym  	детей  
potom tolko kogda wosstanowili	потом только когда восстановили
kum ij tunemym da mo uzh	три года проучилась и это
tudo kajyshetla ana puren myj dekem olashket	по дороге туда анна заехала ко мне в город
pesh kugu jal yle o-oj	очень большая деревня была о-ой
shudyshko jolyshten imnym shogaltenna	к сену лошадь привязали
emzhylan nichego yle	ничего не было
kak storozh	как сторож
dewanosto porwyjet god dech wara	только после девяносто первого года
mo nyl nyl keche kurzhtalyktenut	четыре четыре дня заставили бегать
mogaj unyka	какие внуки
wot pej~	вот п~
da eshe	вдобавок
jorshyn tujeshken omyl myj	совсем не болела
a rweze-wlakshe memnan ludynyt	а ребята-то нас испугались
portym yshten shuktenna da	дом построили и
a-a   mladshij-to zdes zhiwot sejchas bezrabotnyj	а-а   младший-то здесь живёт сейчас безработный
kwartira semyn wet	как квартира да
semidesatyj	семидесятый
mo onal	ничего
tudo tache kushten kandashat   kandash pelylan mijash	она просила подойти сегодня в половине девятого
a kak prihodili k wam ludi w gosti smotret telewizor ili eto	а как приходили к вам люди в гости смотреть телевизор или это
galam yshtymem mongo wiktyr	после рождения гали виктор
myj pyshtyshna i konuk den koktyn weterinarysh nyngajyshna	мы положили его с конюхом вдвоём и повезли к ветеринару
te shinchyza	вы сидите
tide ushemnur-shamych kush koshtynyt	ушемнурцы куда ходили
uke oj jumo serlage	ой боже упаси
wara myjym nalmenge koshtash tora da	потом после женитьбы стало далеко ходить и
dawajte zdes prerwomsa	давайте здесь прервёмся
mo eshe	ещё как
pogynyshna	собрались
wy eto	вы это
jy jyshtak purenam tunam wet ogyt pale	незаметно заходила тогда ведь не знали…
a kugyzazhe ere kutyren kaja muren kaja	а дедушка всё идёт и говорит поёт
nu shke koklashte kalaskalet da	между собой говоришь 
pochtyzhym palet yle olashte joshkar-olashte	почту знаешь в городе в йошкар-оле
pawylym ito	павла и то
oj ukraina stradal	ой украина страдала
aw awazhe gyn	у матери
tyjzhe zh~	ты-то~
koltenyt	отправили
i wik koj kojmo   kojsho lijesh	и сразу становится видимой
myj gyn om oncho yle manesh	я бы не держал говорит
eshe molyzhymat eshe wara	ещё другие ещё потом
aj melnatlan shurashetym	ай крупу для блинов
kajash diskotekysh	пойти на дискотеку
shutochnyj	шуточный
memnan	у нас
net jescho mnogo zhit-to budu chto li	нет ещё много жить-то буду что ли
ty   ty wy ottuda dak znajete	ты   ты вы оттуда так знаете
a eto kak tam z z na zarabotki ili	а это как там на заработки или
tolesh da izishak mo lijesh da uzhe nangajatat yle	приходит да немного побудет уже уводят ее
kunam tunalynat	когда начала
wes mogyret iktazh-mom ojlen pua tugajrakym	другая сторона что-то такое скажет
spasibo	спасибо
so slowami da marij udyr-kache	со словами и марийские невеста и жених
saj uslowij yle	хорошие условия были
nunyn portysht yle kostimytyn port moncha saraj pakcha zr kugu sad una wet shinchet mijenat tyjzhe	у них дом был у кости и его семьи дом баня сарай огород большой сад ты же видела приезжала ты
myj jochazhym modash luktyn koltenam yle kochazhe pokten purten	я ребёнка играть отправила а дедушка обратно загнал
myj kak tide klat umbachynet torshtem tide   met metallolom umbaket	я как с этого амбара прыгну на этот металлолом
i pesnu tozhe i wot razgowor	и песню тоже и вот разговор
a-a achatshe wojnash kajen da kuzhun wojewatlen mo	а-а отец на войну ушёл и долго воевал
shorynam jolashyshke	накакала в штаны
kijar sholyshtash ajsta kajena manyna jal wes jalyshke	вот в этой деревне ядыкбеляк живут и старые люди
na paru myjat kurshtenam	на пару я танцевал
oncho wernak izishak 	смотри и правда вспомнила
shketyn koshtynam tewe tyshke staryj torjalyshke	одна ходила вот сюда в старый торъял
wara	потом…
ushemnurzhat ogyl yle	не было ушемнура 
oskansola	из оскансолы
nu tak u nejo wed i melodija-to ne takaja kak wot sejchas pojut	ну так у неё ведь и мелодия не такая как вот сейчас поют
uke mijen omyl	нет не ходила
oj	ой…
a-a  	а-а  
ik jochazhe yle jogyr izamet	один ребёнок был мой брат егор
ugu	угу
wara acham shke wurzymysh namijen koden	потом отец сам отвёз его в уржум
ere shalashte wel rabotajenam da	работала только разнорабочей
uke yle	нельзя было
tunam wara skorajam wara wyzywajenna koltenna	тогда мы скорую вызвали отправили
wot prodolzhenijzhe umbakyzhe lijesh	вот продолжение дальше будет
ik ijash gajrak ulyna yle tun dek purenam ala-mo	примерно моего возраста к нему что ли заходила
sorykan kurshtymashym ynde ogyna sharne	танец сорыкан теперь не помним
w smysle kto hodil swatat kto prihodil	в смысле кто ходил сватать кто приходил
spetsialistom da	специалистом да
ik keche da semdesat pat desatykym shotlat yle	это будет считаться за один день и 75 соток
optenna tide klat wokteket	сложили рядом с этим амбаром
i slowa-to sowsem ne takije	и слова-то совсем не такие
olorzhym paranga rajonysh koltenut	олоры в параньгинский район перевели
tide tyj kruchok dene pidmym ojlet mo	это ты про вязание крючком говоришь
onchychynzho koshtyktenyt manesh	раньше водили говорят
shymle kok ijash ulam malda yle	мне семьдесят два года говорила
a myjyn choma soremyshte kochkyn shoga	а мой жеребёнок на лужайке стоит и ест траву
patdesat tretij	пятьдесят третьего
rusharnan	в воскресенье
eshe pasham yshtash shonem	ещё работать думаю
lijyn kugu-kugu-kugu pich gyna chodyra	был большой-большой густой лес
oj myjym pire kochkyn kajyzhe yle	ой хоть бы меня волк съел
wara tumna e   r m-m	потом сова э    м-м
 kowamzhat palen	и мама и бабушка знала
kolotka shukym da mo kyshkat yle	бросали мусор от гроба
a-a semdesat tretijyshte lektynam myj marlan	а-а в семьдесять третьем вышла замуж
a woktenyzhe	а рядом
mynar ijash kodynda	во сколько лет остались
juyn shyndenyt da shurgash tunalynyt kredalash dazhe	что выпили начали ссориться и даже драться
chyla were shyp	кругом тишина
ranshe-to nawernoje na prazdniki tolko delali	раньше-то наверное на праздники только делали
tushto	там
shuzharzhe yle	была сестрёнка
potom etot  	потом этот  
awam kaja myjym wursen koda it turlo wet	мама уходила меня ругала не вышивай
tuge dokan	так наверное
wot tyj kuze yshtet	а ты как делаешь
wuchem ynde kunam nuno kino gychyn tolyt	жду теперь когда они из кино придут
w wojnu w we welikuju otechestwennuju	в войну в великую отечественную
aga aga	ага ага
urawnenijym yshten moshtem jamdyzhym no	уравнение умела решать готовое но…
sadlanak pujam	поэтому пруд
i tudo shulen shinchen	и это вымачивали
shishkina wystawkysh shogalynat mo manesh	шишкина на выставку что ли встала говорит
wara wet uli kuwazhe tolyn da myjym mom yshten uzhyn nyngajen	потом ведь бабушка ульяна приехала и позвала меня
tunemash shym kaj da mylam imnym puysht wara	учиться не пошла и потом мне дали лошадь
konganurysh shumesh erden lektynna da rush rweze dene konganurysh shumesh	в конганур утром выехали с русским парнем и до конганура
wot tide ertysh-ertysh	вот к такому выводу невольно придёшь
ala-kuze manyt	как называют
tudo kermychym wele nalyn ulyna	те и покупали
jora	ладно
pagar korshtymylan wet mijenat	из-за боли в желудке ходила
tysacha wosemsot semidesatom godu chto li	в тысяча восемьсот семидесятом году что ли
a potom gde rabotali	а потом где работали
ala muraltet shono	может споёшь подумай
myj kyzyt pyrla	мы теперь вместе
tak i wy s teh por suda perejehali i tak tut i zhiwote	так и вы с тех пор сюда переехали и так тут и живёте
woshtylat wele konechno zhe	только смеёшься конечно же
porjen-shamychyzhe kolym kuchyshyla peshak	мужчины рыбу ловя
u mnogih wed takoj zapor tozhe 	у многих ведь такой запор тоже
tulech wara	после этого
tak	так
a w marijskuju roschu wy nikogda ne hodili	а в марийскую рощу вы никогда не ходили
my ladno jescho bosikom-to ne hodili	мы ладно ещё босиком-то не ходили
a roditeli washi hodili w marijskuju roschu	а родители ваши ходили в марийскую рощу
shinchash tunalesh kak raz	как раз начинает сидеть
wara jogyr izamzhe	потом брат егор
wara tudym ala-kush wes were koltymo godym tudo wokzalyshte wara ranitlaltyn	потом его во время переезда куда-то на вокзале ранило
kuralashet	пахать
wara	потом
no uzhe kyzytak tunalman uzhe	уже сейчас нужно начать уже
i tozhe yshten ogytyl	и тоже не делали
ala-kush nyngajat	куда-то увозили
mitan enyrzhym ala-mo shupshyle	удочку мити что-то дёрнуло
kupsola e-e peledysh kup gychyn torjalysh shumesh shketyn kajenam	из купсолы э-э от пеледышского болота до торъяла одна ехала
s desati	с десяти
nalat	возьмёшь
tolash kumylzho lektyn	появилось желание приехать
ko eshe iktazh-mo	кто ещё что-нибудь
wot munym wara jesharet i tozhe tygakak munym umbalym jesharem	потом добавишь яйцо и тоже так же яйцо сметану добавляю
erden lektym kychkashlan man imnym tarwaten koltyshym myjyn imne kylde-goldo jorlyn kajysh	утром вышла чтоб запрячь лошадь потрогала лошадь моя рухнула
chyla were lups wozyn	везде роса выпала
tunam turin ogyl gyn myj nawerno pagaret den chot tolashem yle	тогда если бы не тюрин я бы наверное долго мучалась желудком
tu preze den wel ushkalym yshtenam	с того телёнка только и пошло моё поголовье
kuzen kochkash	залезть и съесть -
ikana	однажды
a trahsestra jambika yle	а трахсестрой ямбика была
marij muzhik	марий мужик
oj myjyn ojlash gyn	ой если всё рассказывать
myjyn imne chomam yshten	моя лошадь ожеребилась
ti   nu ladno shurget-shurget	это   ну ладно ссоришься-ссоришься
myjyn chomat ala-mom shketyn tolashen	мой-то жеребёнок не знаю что делал в одиночку
a	а
myj wara peshak shylyna yle nunyn dechyn konga shengeke ludyna yle pesh	мы прятались от них за печкой очень боялись…
lariwon kuwa yle	жена иллариона была
myj malen kynelam myjyn uzhe kechywalat shuesh	я просыпаюсь уже обед скоро
kajen	пошла
sosnam tozhe tyshkak tembakak wele eshesh	свиней тоже сюда поближе ещё
chyla erkyn dene pomyzhaltesh	всё потихоньку пробуждается
marijskij jazyk yle ala-mo tushto om pale	марийский язык был ли там не знаю
udobrenij uke parengylan	удобрения не было для картошки
myj   udyr ulam yle i myjyn plan yle ik udyrym ik ergym yshtash	когда я была девушкой у меня был план родить одну дочку и одного сына
kolhoz oksam puen ogyl wet kindym wele puen tunam zernam	в колхозе денег не давали хлеб только выдавали зерно
no patistenka semynet mo	это вроде пятистенки
a kushto yshtashyzhe	а где делать
tumna tum-tum tumna tum-tum	сова тум-тум сова тум-тум
mo  	это  
ili nalme	или покупное
gennadij myjym wuchen	геннадий ждал меня
myjyn eshe tundeche	я ещё из этого
uzhe wolgaltesh	уже светает
wara wozam da myjat malen koltem wara myjzhe malen kodam yle	потом ложилась и я тоже засыпала и оставалась 
kochamet ere kornym kychalesh	дедушка дорогу ищет
it shushkyn shinche manesh yle awazhe	не жри говорила мать
zwenigowo kundemyshte ila	живёт в звениговском районе
chazhetym torlenut	починили тяжи
chernilazhe nalash yle	а чернила можно было купить
peshak poslushnyj shke tunyktenam yle peshak kugu kapan	очень послушная сама научила очень высокая была
mo	это
wara tufletym myj anat dech nalyn kodenam gala dechak chaj	туфли те я у анны забрала у анны кажется
nimogaj korno uke	никакой дороги нет
chomatym purten pukshem yle jal muchashtak kuralyna da	жеребёнка кормила мы в конце деревни пахали
jalsowet	сельсовет
kok tuzhem ijyshte	в 2000 году
bochkina glawnyj wrach yle	бочкина была главным врачом
imne den rabotajash tynalym	начала на лошади работать
myjyn e myjynzh   a rush-shamych iktat uke	мой э мой   а из русских никого нет
shagal dyk mom yshtet mynar kyzyt hot  	мало но что поделаешь сейчас хоть  
kinomekanikshe ulyt koktyn	были два киномеханика
myjym shysht kolto	меня не отпустили
net net ne budu	нет нет не буду
no kol kuzhun ysh wuchykto	но рыба не заставила долго ждать
onchyktash ogyl a prosto myjyn priwychke yle tushko lektyn shogalash yle ere	не показывать а просто у меня привычка была там стоять…
izi wannychkym kondash kulesh eshe	надо ещё маленькую ванночку принести
tynar muren moshtet da manesh	ты так умеешь петь говорит
wich ij e	пять
wara wik kajen otyl bolnitsyshkyzhe mo	сразу в больницу не пошла
tudyn dech wara	после этого
ko kushto kuze tunemesh	кто где и как учится
tyshtet yshtysht	там построили
kok shagat mo shogyltna torshtyl	выпендриваясь мы простояли примерно два часа
kajet da morkysh ot shu	едешь и до морков не доезжаешь
toktajbelak aga	токтайбеляк ага
kyzyte	сейчас
peshyzhe ynem kaj	не очень-то я хочу идти
chernilnyj karandash	чернильный карандаш
pogynenna klass gychyn kolo ik jen	собрались из класса двадцать один человек
no tyjzhe koktynzho wet ilenda sajynak	но вы-то вдвоём ведь жили хорошо
tuge	точно…
wot	вот
a memnanet tushanet shinchen kodyn dyk uke	а наш-то там же остался
e-e toshto torjalysh nyngajenut	да в старый торъял перевели
shkol mekanizatsijysh wara pawyl	в школу механизации потом павел
raz-raz wozgalash wozash kulesh	раз-раз записать нужно
ili zhe	или же
tudymat shonenam yle no~	так думал но~
kazhne kechyn	каждый день
puchkeden jonyshtat sajrak wurgo jesli molodoj	измельчали и мололи если хорошие стебли молодые
dwesti sorok lijyn	давление 240 было
chyla saj	было все хорошо
war wara	потом
jochazhym nyngajyzhe	пусть детей заберёт
pesh nele yle pasha yshtash	тяжело было работать
myj wel torlen optyshym da	я же собирала её
to jolyshtym kuchenyt to eshe iktazh-mom tushto udyramash-shamychyn kuchenyt	то свои ноги держат то ещё что-нибудь там у женщин держат
da kak raz wannym	да как раз ванну
imnetyn	у лошади
w kolhoze	в колхозе
pochingalan	на выселки
wot dwoje zdes wot sami-to starshije	вот двое здесь вот сами-то старшие
wolykymat pogenna	и скотину завели
kunchen	копали
i postrojku tu	и постройку ту
om pale me tushkyzho	не знаю мы туда
jadykbelak gychyn	колька сын пелагеи
adakat	опять
nimogaj shur uke	никакого навоза не было
kosti kuwa wet tozhe ojlen yle	жена константина ведь тоже говорила
podysh puren kajen	в котёл упал
no tudo jora	но это ладно
prosto tak wot sela i prijehala	просто так вот села и приехала
no koneshno wara uzhe peljudet erten da	конечно потом когда было уже за полночь
lu ij wet ilenam myjzhe	десять лет прожила я
a-a   pochti kazhne kechyn jur juryn	а-а   почти каждый день шли дожди
wara temdalesh	потом нажмёт
semdesat semdesat chetwortyjyshto	в семьдесят четвёртом
kazhdyje wyhodnyje	каждые выходные
semonowkyshto	в семёновке
wot	вот
ne ne ja horosho ochen pokushala	не не я хорошо очень покушала
no jydalym yshtash uzhesh yle	но достаточно видел чтобы лапти плести
turlo mogyrysh kajen koltet	в разные стороны разойдётесь
ynde tynar ilenat da kokytsho shuko mo	так долго живёшь ещё два много что ли
no yndyzhym	но
ala rudenam da kuzykten kertyn omyl chara kutan ala koshtynam ko pala	может развязала но не смогла поднять штаны и голая ходила кто знает
noltal koltysh	поднял
bolshe mijen otyl tun dech wara	больше не ходила после этого
jualge	прохладно
nu kuwatat pelenzhe tolesh	ну бабушка тоже с ним идёт
a teper tserku strojat	а теперь церковь строят
kowyshtam sdatlena kolhozyshko	сдаём капусту в колхоз
kurshtymashym moshtash kurshten ogyl	сразу нельзя
ty uzhe wkluchila	ты уже включила
a w shkolu wy kuda hodili	а в школу вы куда ходили
nu kak by shutochnyj	ну как бы шуточный
kochsa kochsa	ешьте ешьте
no kugyza shelesh kuwam	но бабушку он ударяет
shondem peshak joga	моча стекает
w woskresenje utrom prishli a ponedelnik po ponedelnik u ut e   wtornik utrom ja uzh zamuzh wyshla	в воскресенье утром пришли а понедельник э   вторник утром я уж замуж вышла
tygaj manesh	вот так
tide wara matwejewshyn jodash ok lij mo	у матвеева нельзя спросить это самое
m-m-m	м-м-м
ala-mom palen omyl myj latynskijet den	что-то я не знала по-латыни…
tudym sharnem i bolshe 	то помню и больше не помню
myj chechas imnym tuarem da kushkyzham da kajem	я сейчас распрягу лошадь и верхом на лошади поеду
da kushko gyna kurzhyn pyten ogytyl	и разбежались кто куда
imnym kuralash luktych	лошадь вывели пахать
ala-ko oshkyleshak	кто-то идёт
isaj puja	исай пyа
a tysh tolmenge gyn myj imne den rabotajen omyl	а когда сюда приехала я не работала с лошадью
kostimytat perwyj tygak tolashenna manesh	у кости тоже первый раз так же случилось говорит
a potom otets-to   jalsowetom postawili w jalsowet jesli dezertir  jego wso unichtozhat	а потом отец-то   главой сельсовета поставили в сельсовет если дезертир дезертирует его всё уничтожат
kok etazhan yle	был двухэтажный
mo tushtyzho ulo dokan nunyn	там-то у них наверное есть
ala-kunar ijlan nalyn wele	несколько лет получала
tudym awamlan puenyt pa pasha yshtymashte chodyrashte podarkylan	его маме дали на работе в лесу на подарок
ynde rweze-shamychet lishemyt peshak memnan	а в это время ребята приближаются к нам
omsam pochesh	открывает дверь 
a myj portetym uzhalenna tudym da kolhoznyj kwartirysh kajenna wara	а мы дом тот продали и переехали в колхозную квартиру
rwe-shamychemzhe ulyt yle kelshyme rwe-shamychemzhe da	парни-то у меня были с которыми дружила
m	м
tewe wele	только так
a	а
acham armijesh kolen	отец в армии погиб
pesh chaplyn chijenat	что очень красиво оделась
a-a	а-а
myjak onchenam	я же ухаживала
wyshla	вышла
oj hot tudlan tau turinlan	ой хоть ему спасибо тюрину
a-a rowesnik lenina	а-а ровесник ленина
i wara kunam shochynzho shkezhat ok pale yle	и она сама не знала когда родилась
wara	потом
shonalte-jan mogaj murym	подумай какую песню
wish wel yle	одни дырки
dwadtsatyj martyshte kandashlu kandash ijym temem	двадцатого марта восемьдесят восемь исполнится
no tunam tselina yle wet	тогда ведь была целина
a wystawkysh shogalmyzhym myj om pale mo tygaj tide wystawkysh shogalme	а что на выставку встала я не знаю что это такое на выставку вставать
mo m-m	что м-м
kuzen kochkash	залезть и съесть
latkok marij kulesh znachit	двенадцать мужчин нужно значит
zhapyshte shuko wud jogen erten	за двадцать лет много воды утекло
lozalp	лозап
mijenam mijenam	ходила ходила
m	м
shudyr lijyn jytynet ala-kunar i mundyra	и у меня веретено было пряжи немного и клубок
oj-oj-oj-oj kok kechyzhe ilash pesh joso	ой-ой-ой-ой два дня прожить и то очень трудно
kapka onchykyzho imnym shogalten	лошадь поставил перед воротами
a kochkashyzhe	а еду…
wokzal gochynet jolyn ere	вокзал всегда пешком
beda chot jushto	было очень холодно
tsibiknur wes mogyryshto kushnur yle	за цибикнуром был кушнур
tak prosto	так просто
ludyktashlan lumyn	нарочно чтобы пугать людей
u nas nurener-to bolshe nich   nikto nichego netu	у нас нуренер-то больше никого ничего нету
mo samolotym spirt dene mush da it ju tide lijyn kertesh mo	а что самолёт спиртом мыть и не пить разве это возможно
myjym	меня
pujam gyna	пруд только
na sani dali jej 	на сани дали ей 
ne-a	не-а
eshezhe  	ещё  
memnan jal olmyshto	на месте нашей деревни
ynde chisti noreda noko dawajte	вы ведь полностью промокнете ну-ка давайте
tudyn den tunemym myj tunemash pidynam	от неё научилась я вязать вязала
shurzhym wet kolhozyshko chyla nyngajat yle	весь навоз в колхоз забирали
mo	ну
en perwyjzhe wet shym port radamysh tolynam myj	сперва я приехала на улицу в семь домов
me jesh den rabotajena kowyshta den chylan	мы с семьёй все работаем на капусте
julen kolen	сгорела заживо
uzhe kugeche	уже пасха
tonjed wozam kotomkatym sumkatym	ложусь кладу под голову котомку сумку
no kolyshtyktat tushto wara	но там будут слушать
tachat tyshtak	и сегодня здесь…
muchajus no zhiwu	мучаюсь но живу
udobrenij nawerno	удобрения наверное
e nu kuze manash gyn	ну как сказать 
ochen wkusno ja tozhe mnogo sjela	очень вкусно я тоже много съела
oj shornem oj shornem manyn	говорила хочу в туалет хочу в туалет
judym tolyna tushto cheret lijesh aptekyshte	ночью возвращались там очередь в аптеке
a	а  
ik ganat tujeshken omyl myj wara	ни разу не болела потом
rweze kalyk shke ojlymyzh godym shuko rush mutym purta	молодые люди при разговоре вносят много русских слов
udyr koshtesh	девочка ходит
puren shogale tudo a myj umbake kurzham nunym ludykten	она остановилась а я дальше бегу их пугая
nyl ij rabotajyshym	четыре года работала
a~	а~
myj	я
tudo shinchen wtoroj etazhyshte washtaresh klatyshte memnan	он у нас стоял на втором этаже в чулане напротив
ukrainu-to kak kormili le	украину-то как кормили
kugyza uke	дедушки нет
chyla molodozhet pogynenna	мы вся молодёжь собрались
oloryshtat tyshtat	и в олорах и здесь
nu ik shotsho den tozhe wet   tyge tewe	ну с одной стороны тоже ведь   так вот
a wara	а потом
dejstwijzhe kaja	действия идут
spasibo	спасибо
kugeche agawajrem	в пасху и агавайрем
urzham tunam	тогда рожь
udash kulesh	надо было сеять
shym imne ik ushkyzh	семь лошадей и одного быка
kok chazhge myjyn kurlyn	оба тяжа у меня оборвались
i anam pyrla nyngajenut	и анну с собой взяли
o oksazhym chyla shkeak kuchysht	все деньги сами истратили
i muynam ik karandashym	и нашла один карандаш
ala nachalstwo kochkyn armijyshke mijen shuyn ogyl ala	может начальство ело до армии не доходила
ja wot ruku otorwala	я руку вырвала
tunamzhe	тогда-то
portym yshtenna u portym myj mijymenge	дом построили после моего приезда
mo   gramotyzhat pesh chot shuko ulo kugyzamyn	у моего мужа очень много грамот
jalyshtyzhe mo ala-kuze mom yshtenam mo me rushla om pale	в деревне-то не знаю как по-русски
tushko	туда
chewer kenjezh ertale	прошло красное лето
namijen suaram shuko gana namijen	привозил сухари много раз привозил
ere er shuen ere mo	наступает утро
tudym ere kocha pesh poga yle 	их дедушка собирал
oj latkokyt denzhe	ой с двенадцатью
ot mu	не найдёшь
w armii	в армии
nymat ogyt pu yle	нам ничего не давали
tyjzhe tushto wara posna ilenda	вы-то отдельно жили
portym nalash wele uke ok uzhale	нашли дом нет не продают
da wutash ogyt purtykto yle	в хлев не пускают
prezat ogyl	не телёнок
konuk den koktyn imnym e-e   chomatym pukshash tolashena	вдвоём с конюхом жеребёнка пытаемся кормить
ik dwizhenijym wes dwizhenijym onchyktenam ok moshto	одно движение другое движение показывал не умеет
nu a kush nyngajat yle	ну а куда увозили
tak	так
weterinaryshte imne shincham onchash	к ветеринару осмотреть его глаза
a	а
matematikym ala-kuze sharnem 	математику как-то помню 
posadili na woz	посадили на воз
aj wishk wish wishkyde manyt da ili kuze	ай нет жидкой говорят да или как
jeshnat ulo	и семья есть
nylyt lijesh	четыре будет
shkolyshtyzho   mogajrak tunam uslowijzhe yle	в школе   какие тогда условия были
wara mujym flage dene opta izorwa dene shupshyn nyngaja yle torjalyshke	потом мёд в фляге на ручной тележке увозил в торъял
toktaj toktajbelak ot nas dwadtsat dwenadtsat kilometrow	токтайбеляк от нас в двадцати   двенадцати километрах
ik onaj istorijym shkenan jalna nergen kalaskalen puem	расскажу одну интересную историю о нашей деревне
shuretym ere wet	навоз-то ведь постоянно…
tide jalyshtak traktoristyn ergyzhlan	в этой же деревне за сына тракториста
tyshtak ilen umyrem shu 	здесь же жизнь прошла
sushilke shincha yle	стояла сушилка
wu   moet gychyn tolmenge wara	после приезда с этого потом
chylan pogynenna da	вот все собрались
nuno koktyn onchen kushtenut ik ergym shym udyrym	они вдвоём растили одного сына и семь дочерей
eshe kok rweze-shamych	ещё два парня
postaratsa manme gajak	постараться как бы
tygaj ojgyzhym ny uzhyn	какого горя ни видала
molan zhapym kuchet zanimatle a shurtyzhym molan loktylet	почему время тратишь занимайся а нитки почему портишь
ere wyzow	постоянно вызовы
no tudo udyramashyzhe kaja yle tudyn deke	но эта женщина к нему уходила
a myj tudyn shochshyzhym ona oncho	а мы не будем смотреть за её детьми
kechylan kechyzhym nalyn kertynam ala uke	да и за день я едва ли могла заработать один трудодень
lijyn isajew familijan	по фамилии был исаев
wara	там
myjyn choma kolysh	мой жеребёнок подох
oh	ох
ere gyn mo  	постоянно это  
myj kushech palem	я откуда знаю
kombo pokten woltymem godym juchik tucho da	когда гнала гусей вдруг что-то хрустнуло в ногах
adak mura	снова поёт
shalash kajen ot kert	помочиться сходить не могу
trudodnam	трудодней
myj acham dechyn kodynna  	мы от отца остались  
da jamdylyme atyshke purten pyshtysh	и положил в готовую тару
mo kochmymak sharnem da pakcha kunchymym sharnem sharnem	ну про еду помню и… как огород копали помню
oksam wel puash tunalynyt yle	только начали выдавать деньги
tyge ojlet yle	так рассказывала ты
kalyk mujym kochkyt kuzat da mylam shumtorykyshko	другие мёд ели когда качали а мне в творог добавляли
izder den shupshyn namijen	на санках привозил
wurzymyshko gyn myj	в уржум я
poro ilyshyzhym uzhyldalyn omyl gynat	хорошей жизни хотя не видела
tidet lijyn	это было
wara juash tunalyn	потом начал пить
noko-noko-noko pesh chot shuko wud pura-ys	ну-ка-ну-ка-ну-ка очень много воды
a-a   s roditelami muzha plohije otnoshenija byli	а-а   с родителями мужа плохие отношения были
tunam pesh shortynam yle	тогда сильно плакала
kuzhu zhap kutyren shinchyshna	долго сидели разговаривали
wot mogaj godyshto	вот   в каком году
oj kumushka ilymet godymat pesh orlanenat	ой кума при жизни так страдала
myjym shinchash koltenyt	меня на посиделки отправили
oncho pirym uzhynam man ojlenat yle tyje	смотри ты говорила что я волка видела
wozhylam wele	аж стесняюсь
a ja pojdu ostanowlu mat potomu chto ona ochen gromko weschajet	а я пойду остановлю мать потому что она очень громко вещает
mogaj tide operatsija o	значит операция
wara myjyn   kunchylatym shudyrenam dyk	я пряла пряжу
iii  	иии  
izi godym izi godym	в детстве в детстве
kyzyte	сейчас
ala-kuze puren tyge	как-то он туда попал
yndyzhe witle kok ijym temenam dyk	теперь мне уже пятьдесят два года исполнилось
izwatylan tolyn	была второй женой отца
trahomyzho tunam oj pesh chot shuko trahom yle	трахома тогда очень много трахомы было
tewe rweze-wlak memnan deke peshak kurzhtalyt	из ядыкбеляка
mushkyryshto kodyn	в животе осталась
isaj puja kuze shochyn	как появился исаев пруд
myjzhe ala-kuze kajen omyl eshe jora	я как-то ещё замуж не пошла ладно ещё
tyj suan dene mijenda mijen ulyda wowkazhyn	а вы ездили за невестой у вовки
myjyn imne ter kutysh kaja da shogalesh ter kutysh kaja da shogalesh	моя лошадь немного пройдёт останавливается немного пройдёт останавливается   
oj pesh shuko logalyn da zapominajuschij ko lijyn gala	ой много раз приходилось а кто был запоминающийся
pualtat wate-shamych tuge tolashen	женщины веют зерно так стараясь
umbalym   wele	сметану только
kawyrlan sepanyn nuno onchychrak nalynyt	у кавырлина сепана  они раньше купили
uke-uke tudo	нет он
a kochatshe	а дедушка…
a ne znaju ka   tri raza goworit eto jezdil	а не знаю три раза говорит ездил 
konechno zhe wot	конечно же вот
jyrzhe turlo sad kushkesh 	кругом разные растения растут
ili   storozh olmesh mojn chyla	или   сторожем работал
wetkat den	с веткой
kozho pyshta munym	кто-то ложит яйца
koneshne awgust tylze uzhe	конечно август месяц уже
wara myjzhyn kajash prishlos	а мне потом пришлось уйти
jur pesh juresh	идёт сильный дождь
imnet pesh talyn koshtesh myjyn	лошадь очень быстро передвигается
tuletym jorykten tulym da mon shukym korandenna tushech	потушили огонь очистили место от мусора
awazhe shukshu	мать старая
oj manam myj ukrainlan werchyn kunar shuzhenna	ой говорю из-за украины сколько голодали
oskansola ok purto	оскансола не принимает
me kumytyn	мы втроём
kum unykan kowa ulam ynde	я теперь бабушка троих внуков
akam den ulij modyn tolynyt da sholdyra walne malat	сестра и улий с игр пришли и спали на полатях
w poslednij raz w japonskom wojne byl dak	в последний раз на японской войне был
tugaj shyl da mojn uke wet	мяса да что да не было
chisla dewatnadtsatojeshto ijulyshto	числа девятнадцатого июля
da wet myje	а я
wot ikanazhe ojlenam	вот один раз сказала
myj kumshyzho ulam	я третья
tudym lijesh nele ogyl	это можно нетрудно
a-a   odin zhiwot starom torjale dom sam postroil	а-а   один живёт в старом торъяле дом сам построил
pesh druzhno ilenut	очень дружно жил
kusotyshkyzhat	и в роще
a-a	а-а
mom wara lechitlenytshe	и что лечили
tudo tuge tunalyn	это так началось
w ukrainu otpustili	в украину отправили
konganuryshto	в конгануре
ik muzhikym shkol woktene	одного мужика рядом со школой
mm	мм
ynde kugyza chisti oryn	дедушка очень удивился
stipendijet trojkylan uke chet chetworkylan wele	стипендию не давали за тройку только за четвёрку
a-a   mat   iz sernurskogo rajona	а-а   мать   из сернурского района
katyk kumyzh kongambak	колотая миска на печку
tidyzhe pesh sajzhe ogyl da	это конечно же не очень хорошо
sudit ne budut nawerno mena	судить не будут наверно меня
wara~	потом~
kajen arna koshtyn	поехал неделю проездил
d dewchonke-to hodila	к дочери-то ходила
shestnadtsat wy goworite u was wnukow	шестнадцать вы говорите у вас внуков
awazhe tushto akasht tolynyt	мать и сестра этих ребят пришли
m-m	м-м
oj esheat ojyrlen ogyna kert	все ещё не можем расстаться
moshto  	это…
chyla udyramash-wlak yshtenyt	все женщины работали
mom e-e   t tolynam patdesat wtoroj godyshto dak	это… приехала в пятьдесят втором году
ko kush tynalyn	кто куда начал ходить
awan shujyshko kerzhaltam eshe tudym kertynam kidem koshar gaj gynat	маме на шею вешаюсь ещё это могла хотя руки были как коряги
koshtyktenam	носила
perwyj klassysh kajymem myj tache keche gaj sharnem mom chijenam	как в первый класс пошла я как сегодня помню во что была одета
kud ijzhe erten	шесть лет прошло
tu bojkoj wate	она бойкая женщина
memnalan pajremlan wele puksha yle	нас только по праздникам кормил
wot klat e   pusta klat nigo tushto ilen ogyl	вот амбар… пустой амбар никто там не жил
e-e kwartir semyn	да как квартира
o-oj	ой
sharnaltash kuze mo	вспомнить как что
sheshke purtymysht godym	на женитьбе его сына
no kolen omyl	но не умерла
tulech wara pagarem ik ganat korshten ogyl	после этого желудок ни разу не болел
tumna tum-tum tumna tum-tum	сова тум-тум сова тум-тум
da kugyzazhe pocheshyzhe aj	а дедушка следом
glawnoje nyngajenut	главное увозили…
kombo den	с гусём
kalyk manesh dwesti dwadtsat den kolat manesh	другие говорит с давлением 220 умирают говорит
rajon muchko pogynen	в районе собравшись
zra chot tylze wolgydo beda chot sharnem	месяц ясный очень хорошо помню
tide kechyn me pyrla tunemshe-wlak washlijash kutyren kelshenna yle	в этот день мы договорились встретиться вместе с бывшими одноклассниками
no tuge gynat chonnazhe ere samyryk	но всё равно в душе мы всегда молодые
knagam kondat	бумажку привозят
i tudo pochti parengylan werchynak	и он почти из-за картошки
shym kwartiran    portyshto ilenda	в семиквартирном… доме жили
jyrsalma da kugu urem da chywe urem da agytan urem da	йырсалма и кугу урем и чыве урем и агытан урем и…
kajykynat muryzho jongaltash tunalyn	пение птиц начало раздаваться
tyshte mesta lijyn medpunktyshto	здесь место было в медпункте…
molan manat	почему мол
znachit i otets wash uchastwowal w russko-japonskoj wojne	значит и отец ваш участвовал в русско-японской войне
a myjyn tolmyzh godym uzho	а когда я приехала уже
a tushkenzhe eshe ik surtym yshtenna yle	а до этого ещё один дом построили
a tembalnyrakshe	а поближе
i nunysht wara erkyn mongo   mongysht kajysht	и они ушли домой
tulen ala-mynar	платила сколько-то
zasluzhennyj pashajen medalymat puenut	как заслуженному работнику ему медаль дали
tunam showyn uke yle wet	тогда мыла не было ведь
kandash ijashym kajenna	в восемь лет шли
kuze tudym muynna	как мы его нашли
sowetskij akamet	из советска сестра
wolodan olmyshto	на месте володи
eshe ona tol yle me ilena yle	ещё не приехали бы жили бы
teper wo wosemdesat shest aj wos wosemdesat sem wosemdesat wosem budet skoro	теперь восемьдесят шесть ай восемьдесят семь восемьдесят восемь будет скоро
chazhetym yshtysht da	тяжи починили
ozhnyzho wet prohod den koshtynut	раньше-то в церковь по приходам ходили
wara parenge shyndashlan adakat	потом опять на посадке картошки
kok ergym	двух сыновей
stepan gawrilowich wet tozhe	степан гаврилович ведь тоже
tolyn da awyj malda kochkash mylam mom tamlym pukshet	зашёл и говорит мама что мне вкусненького дашь
wara wes gana adak	потом в другой раз
tolko mena puskaj ne sudat	только меня пускай не судят
perwyj klassysh kajenam wara	в первый класс пошла потом
tyj wara tidetym pyshtet tu  	добавляешь ту  
chetyre wnuka	четыре внука
tuwyrtyshwudym pyshtet	нальёшь сыворотку
wot kogda	вот когда
skazhite tak ne wozrazhaju	скажите так не возражаю
shkol pajremym ertaryshna	проводили школьный праздник
ogurtsy	давайте пойдём воровать огурцы в другую деревню
ilash tunalynyt	начали жить
unala kajen mongyzh gych	она уехала в гости из дома
mushkedash	стирать
nazar	больная
myj diabetik dyk	я диабетик
poro ilyshymak uzhde lijym	но хорошей жизни не видала
mo lariwanzhe garmonist dyk	ну илларион-то был гармонистом
i nalyn ogyl pensijym	и не получала пенсию
nu i chto	ну и что
da	да
tochnyzhe manash dyk	точно если сказать
a nunysht primerno kunamrak nalynyt onchychrak chot onchychak	а они примерно когда купили раньше намного раньше
tri klassa tolko konchila	три класса только кончила
a w nurenere byla tserkow	а в нуренере была церковь
lektyn kurzhesh port gychyn	выбежала из дома
tozho	тоже
myje	я
mo lesouchastke	что лесоучасток
aj lariwon wate	ай жена иллариона
i wot	и вот
tide pujan istorijzhat pesh onaj	у этого пруда и история-то интересная
luktat da wara izhe wet shurashyzhym optet	вынимаешь и только тогда наносишь крупу
wsego bylo dak jescho zhiwu	всего было дак ещё живу
i ty kak raz tewe tolyn shuyn tide keche	и вот как раз наступил этот день
tetrad lijyn ogyl nawerno  	тетрадей не было наверно  
i tulech molat	и прочее
a pos pasushto mogaj gyna juk-juan ok shokto	а в поле каких только голосов не слышно
enyryshtym putyren	собрали свои удочки
u jydal pachashur noski	новые лапти жёлтые носки
erla kajeda	завтра пойдёте
umbak ala-molan yshten shyndenut idym yle	дальше было гумно
tygaj kechan erdene mita den wita	в такое солнечное утро митя с витей
no	ну
wiktyr afanasich konstantin nikolaich memnan pawyl nuno dwadtsat sedmoj ulyt	виктыр афанасич константин николаевич наш павыл они двадцать седьмого 
ne-ne	не-не
kunam eshe shkolym chonjenyt wele	когда ещё школу только что построили
a-a	а-а
myj wara kaza dene wele kodynam kazazhymat acha-awa wele	я осталась с одной козой и козу-то родители только 
potom prozorow nikolaj kupil potom maksim wasiljewich glushko u nih desat   desatero bylo detej	потом прозоров николай купил потом максим васильевич глушко у них десять   десятеро было детей
jescho pojmajut te teba dak	ещё поймают тебя
kajenna	пошли
dwizhenij-shamychym wozgalash	движения записывать
a wurzymysh ala-molan koshtynyt	а в уржум почему-то ездили
witaminym jukten koshtyna yle port jeda	витамины ходили поили по домам
a-a tide shurashyshket pyshtenyt	а-а это добавляли в крупу
ni pensii ne bylo i ne ranenyj byl dak ni gruppy ne bylo i pensii ne poluchil	ни пенсии не было и ранен не был ни группы не было и пенсии не получил
‎myj tyshtak ulam manesh kuwazhe	я тут говорит бабушка
a-a	а-а
keche muchko tolynam	ехала целый день
ale kutuat kajen ogyl yle	даже стадо коров ещё не выгнали
tyjzhe kushto   mom ojlyshtat	ты где   ты что говоришь
tudo memnan	она у нас
mo toshto torjal shkolysh koshtmet godym	в староторъяльскую школу ходила когда
i tushto uzhyn objawlenijym kurskamet	и там увидел объявление… дядя-то
mom	что
e-e	да  
rody prinimala oj mnogo	роды принимала ой много
kindym wozitlena	возим зерно
ugu	угу
peljud erten	полночь прошла
kolkozlan mogaj kolkozlan puat	колхозу какому колхозу дадут
tygerakyn	вот так
a tyshte udyrjuysh onchashet suan onchashet kudweche tich kalyk uremyshte kalyk	а здесь девичник посмотреть полный двор полная улица народу
wes jalyshke kajenyt	уходили в другую деревню
a syn-to tot  	а сын-то тот  
tu dwadtsat shestoj	он двадцать шестого 
wara	потом
ne bylo	не было
kas marte ere jol umbalne	до вечера постоянно на ногах
wara erlashyzhym erdene kombige onchash lektynam da kombiget kombige umbalne chyla pachashur ora kojesh bolshe nyma ok koj yle	потом в следующее утро вышла к гусятам а гусята… над гусятами всё стало жёлтым больше ничего не видно
awam ushemnur jal gychyn nalyn	отец взял в жены мою мать из деревни ушемнур
a kochamzhe eshe kindym pua manat yle wet	а дедушка ещё хлеб давал говорила ты
kudwechysh wel shogaltenna imnym	во дворе оставили лошадь
sokyr lijynam da kajenam tozhe	когда ослепла тоже ездила
jumyzhym syryktyl pytarenyt da	бога-то уж прогневали
myj sorokowoj godyshto wel tunemash kajenam	я только в сороковом году пошла учиться
tudyn kum igyzhe lijyn	у неё было трое совят
tyjzhyn manesh juketshe shokta	твой говорит голос слышен
e	да
ala chynak ojlen	может правду сказал
familij lumesh	честь фамилии
ikana wishnym peshak pogyktynem walerij den sashik mijen	однажды вишню заставила собирать когда валерий и саша приезжали
chonysht pyltka kuanyshe ulyt	душа поёт они рады
chyla konkretnyjzhym mana pesh shincha yle da	всё конкретно маня знает
gennadijym yshtyshym	геннадия родила
myjyn	мой
wara wursash tunalyt	потом будут ругать
tuge kochkam yle myj shketyn tudym	так и ела я одна
trahsestra tunam trahoma pesh chot mo lijyn	трахсестра тогда трахома очень была распространена
shoptyrym	смородину
myj medpunktyshto ulam yle shketyn	я в медпункте работала одна
lektyn shogalynam klassyshke onchyko koridoryshko	встала перед классом в коридоре
no tyge shinchyme godym	но во время этого празднования
aga a mat	ага а мать
tu patdesat sedmoj godyshto julysh tozhe	она в пятьдесят седьмом году тоже сгорела
rush predsedatel yle	русский председатель был
pesh kugu	очень большое
ku ku kugyzazhe i solash lektyn	дедушка и вышел в деревню
nazar ulat dyk	если тебе плохо
shorykym	за овцой
erla tolam da luktam	завтра приеду и вытащу
i nalash nygushto uke	и негде купить
bolnoj gruppa perwyj gruppa	больной группа первая группа 
chyla ikteshlen a kodat polekym kuchyktat	подводя итоги вручают подарки
oksam tulat mo myj om shinche	деньги платили ли я не знаю
nimo kodyn ogyl	ничего не осталось
uke uke uke jalet pytenak chisti chisti nyma uke	нет нет нет деревня совсем исчезла совсем ничего нет
tudo myjym tunykten	она меня научила
i tide owartyshetym pyshtat	и эту опару добавляли 
tide istorijzhe	эта история
pushenge yle	дерево было
wot ozhnyzho yshtenyt melnashket pyshtenyt o-o	вот раньше делали в блины добавляли
wot nunet tolynyt da me shurgash tunalna	вот они пришли и мы начали ссориться
samyj-to starsh starshij-to sorok chetwortogo goda	самый-то старший-то сорок четвёртого года
port gychyn lektyn kurzhesh	выбежала из дому
wojna dech wara	после войны
no tunam medpunkt tysht tyshtak medpunktyshto yshtenat	но тогда медпункт… здесь же в медпункте работала
iz a~	~
wara portym pawyl yshtash tunale	потом павел и начал строить дом
umyrzho muchko ere tudo kolhozyshto yshten	всю жизнь он всегда работал в колхозе
kuze ojg kuze ojgan ot lij	как не печалиться
mom   emetym chyla pogen namijem da onchyktem da	я забираю с собой все лекарства показываю 
par-to sidit a	пар-то сидит а
kochetym   matwejewetym najda uzhykten wet	ведь надежда этого матвеева пригласила
ala-kush shumesh imnem kaja yle	не знаю куда бы поскакала лошадь
santrojka pesh prowerajena yle wara	мы в сантройке очень проверяли
tushto myj jomynna	там мы и потерялись
da	да
portsho tyge yle wara tushto washportym yshten yle acha	вот так стоял дом а потом отец там построил вашпӧрт
kotoryje poluchshe-to zhili dak	которые получше-то жили
ludynyt magyren	испугались крича
on woobsche uwoz wso strojenije s soboj tam i dom	он вообще увёз всё строение с собой там и дом
cherkyshkyzhe	в церковь
marij jylmym shukynrakyn da shukyrakyn mondash tunalyt	больше и больше забывают марийский язык
myj dyk u ukrainym ere wursem	я украину всё время ругаю
kolo kandash port yle tolmem godym	двадцать восемь домов было
otets prijom u brata syna prinimal nu zhit	отец у брата сына принимал ну жить
tyge	так
on tri raz hodil w armiju-to dak	он три раза ходил в армию-то
kum chaslan kynel kajena yle	в три часа вставали и уходили
kurtkym nalyn kodenam ana dechyn	куртку оставила у анны
tridtsat patyj da sorok wtoroj	тридцать пятый да сорок второй
plenu tri goda zhil	в плену три года жил
witalij iwanowich direktor yle	виталий иванович директором был
a sejchas	а сейчас
wes tanetsym kurshtymashym	другой танец пляску
da enyrwaram nalyn	и взяв удочки
wso rawno iktazh-mo tygaj   lijyn kaja man	всё равно что-нибудь да происходит
chywat ulo	и куры есть
wolykshymat pyrlak onchenna ~	и скотину вместе держали~
kychaltyl koshtat	ходишь-ворчишь
bolnitsyshket mijymetym	как ходила в больницу
wot a-a	ну а вот
shuj luzho todylt kolen	и она умерла от перелома шеи
umbalnyrakshe tridtsat perwyj delanke uchastke yle	подальше тридцать первая делянка была участок
kuwatat pesh tazazhe ogyl	и жена не очень здорова
myj om uzh wet	я ведь не вижу
kuzenat kochkam tum-tum	залезу съем тум-тум
wara ushemnurzho pytysh pytysh pytysh pytysh	потом ушемнур начал исчезать исчезать исчезать исчезать
memnazhyn kosti kuwat  kutyren yle chaj	у нас ведь ещё жена константина говорила по радио говорила вроде
tem boleje awgustyshto tudo arnazh tudo arnashtyzhe	тем более в августе на той неделе
kuznech gychyn brigadir adakat	из кузнецов бригадир опять туда
wara awat myj imnym chamanem	потом я лошадь пожалела и мама
kushto gyn piryzhe manyn tyge shonen kijem	где хоть волк-то ходит так лежу и думаю
a molan kajendazhe tushkyzho	а почему туда-то уехали
a  	а  
tyjyn pekesolashte kurskat ulo	у тебя в пекесоле есть зять
kuze myj wet pidash	как я вязать…
kuralam da eshe kana kanyme godym	я пахала и во время отдыха
mongesh torshta	отскочит
ko udyramashyn jolzhym kuchen shogalynyt	кто у женщин ноги держит
tewe ynde nylde ij jol dene tolashem	теперь вот сорок лет мучаюсь с ногой
aj no poprobujem tozhe da	ай но попробуем тогда
no ynde mynar ij lektesh gala tide tyshte iletshe	но сколько лет теперь живёшь тут
a eshe mom pogenyt	а ещё что собирали
aga i roditeli tozhe	ага и родители тоже
oj judym koshtyt manesh kychkyren srawochlan	ой ночью ходят говорит будят… из-за ключа
ilysh kornet nergen	о жизненном пути
adak rywyzh   rywyzh tolesh da ojla mura adak	опять лиса приходит и говорит поёт снова
m-m	м-м
nu tudyn dene kutyraltyshna tomu proche	ну мы с ним поговорили
ty goworit dewanosto let zhiwosh	ты говорит девяносто лет проживёшь
a myj wara tunam ush ushkal fermyshtet yshtenam da	а я потом тогда я на ферме работала
onchych	раньше
pochinga pochingak	выселки есть выселки
manyn tudo shonaltysh	он думал
mynar ij gychyn uesh marlan lektynat	через сколько лет ты снова вышла замуж
kuze terzhe tushko tolyn	как сани там появились
wara  	потом  
uzhalymem sharnem	как продавала помню
wot naprimer kastene shonenda	вот например вечером подумали
da	и
mukshym onchen mukshym	пчёл держал пчёл
lijesh tygaj melna	получаются такие блины
w toktajbelake	в токтайбеляке
patdesat dewatyjyshte ilash purenna	пятьдесят девятом заселились
a   tudo rweze-shamychyn acha	ещё отец этих ребят
mongo da mojn kazhnyzhe puren lektyn dyk	и каждый пока шли домой заходил
oj pesh chot prowerka dene tolyt yle ola gychyn wrach-shamych	ой очень часто с проверкой приезжали из города врачи
postojanno	постоянно
ko kogda paru spashesh	когда пар вспашешь
toktarsolashtyzhe	в токтарсоле
ere santrojka ulam yle myj kolho mo   shkolyshto kazhne ijyn	постоянно в сантройке была в школе каждый год
kok ekzamenym myj akametlan sdatlenam	два экзамена я за сестру сдавала
kokymshyzhe anisija	вторая анисия
shurash   aga shurashyshket umbalym pyshtenyt shinchalym	добавляли в крупу клали соль
poka jomyn ogyl	пока не затерялась
nalash kushtenyt	просили забрать
pesh chatkan chijenamet da tudlan	очень красиво оделась и поэтому…
kuwar wokteket	к мосту
imnym ik gana yshtyktenam	один раз приняла у лошади жеребёнка
mo yndyzhe sitat yle da wet mom yshtet ojlymo dene ogyl	теперь и хватило бы но что поделаешь от нас не зависит
ala om pale	не знаю
wara sholyzho yle	потом был младший брат
witle kumytsho da	пятьдесят третий
uke-uke ok kaj tide moshket nangajat	нет нет это туда увезут 
kazhne manash dazhe kazhne tygaj pra pajrem godym	во время каждого праздника
tide kalaskalymash wozaltesh	эта запись сделана
chylazhat sharnaltyn	все вспомнилось
shuzharem ulo	у меня есть младшая сестра
tushko mijenna anisolashke mijenna kuznechysh	туда ходили в анисолу ходили в кузнецы
salmagindyzhym kuze yshten kowam om pale	салмагинде как делала бабушка не знаю
logalynamzhe	попала
jeke luman ergyzhe yle	сын был по имени иннокентий
kuwa chisti oryn	бабка очень удивилась
sheshkyzhe kudo sheshkyzhlan tynar mijenyt yle	за снохой за которой снохой они столько ездили
ilyshemzhat nele	и жизнь трудна
mom   e-e  	это самое…
wot tide spaslan	вот на спас
mo yle	что было
a-a podysh kushto portyshtak	а-а в котёл где в доме
sajrak chodyra ukrainysh	лучший лес на украину
i imne kapka onchylan wozyn da kolen	лошадь упала перед воротами и подохла
washportsho	что такое вашпӧрт
pizh-chulkalan	на носки-чулки
pasha yshtashet kulesh tak jochatym	надо работать рабочая так детей
molbische manyt mo	мольбище что ли называют
ala-molan tunalyn	не знаю отчего
u ne   u nekotoryh	у некоторых
stepan gawrilowich byl on agronomom rabotal dak ne znaju w kotorom godu ne pomnu	степан гаврилович был он агрономом работал не знаю в котором году не помню
morko gychet unch uncho udyr	с морков девушка с унчо
kunam lektynam myj	когда вышла я
my tak   tak-to prawoslawnoj wery	мы так-то православной веры
myjzhat mushkyna yle	мы тоже мыли 
pagarem korshten	желудок у меня болел
shke chyze wodyr manyt	два кольки сын фёдора про прозвищу чызе
wesym	другого
e-e po puren kocham purtenyt	э-э в дом… зашёл дедушку завели
shke medik-shamych koklashte pogynena da	когда медики собирались
wurlen kolen	от потери крови умерла
i eshe	и ещё
kochkynna tudym myj mongyshto	ели его дома
tygeat manyt tygaj jomak ulo da	и так говорят такая сказка есть
raz	раз
osal yle kochamzhe	злой был мой дед
a otets wy znachit skazali u was byl tysacha wosemsot semidesatogo goda rozhdenija	а отец вы значит сказали у вас был тысяча восемьсот семидесятого года рождения
tudo dwadtsat shestoj	он двадцать шестого
rwezyzhe	парень
tushko myj kuzenam tide pachashur noskietym chijenam   muynam kudym shkolyshket chijenam	туда я залезла эти жёлтые носки-то нашла которые в школу надела
pujashkyzhe kolymat kolten ulyt ulmash	и даже запустили в пруд рыбу
myjyn  	моя  
yle	была
wet tide kolym nuno mongysht nangajen	ведь эту рыбу они понесут домой
myj sorok wosmoj godash ulam	я 1948-ого года
nangajat da wara	увозят и
no chijash tudo yshta yle	но одеваться у неё было
taza otyl	нездоров ты
kyzytat imne konukak	и сейчас работает конюхом
wara choma kolysh da	жеребёнок подох
a magazinyshte kalyk tich ulyt	а в магазине полно народу
memnazhe eshe izish pel shagat nare shinchyshna da	мы посидели ещё немного полчаса
memnam kowa wele onchen	за нами бабушка присматривала
wara prodawetslan puren	потом продавцом стал
kotelok	котелок
erkyn dene nemda enjer deke lishemyt	потихоньку приближаются к берегу немды
tushto myj shuko kijenam kum arna ala-mo olashte	там я долго лежала три недели что ли там
parenge ere parenge dene ilenna	на картошке на одной картошке жили
om pale	не знаю
torjalyshte wot ik lida ulo	в торъяле вот одна лидия
kokam deke	к тёте
wozymyzhym	запись
wara suan shotshym yshtenda mo	а свадьбу-то сыграли
takshym	так-то
i tu uchastnik wojnylan shotlaltyn	и он считался участником войны
nina sergejewnazhe manesh	нина сергеевна говорит
pasulan wet udobrenij da mojn lijyn ogyl ozhno tolko shur	для поля ведь удобрения не было только навоз
tushto uzhynam myj pirym	там видела я волка
tyshtyzhat koshtynut ulmazhyn	и тут оказывается ходили
wara uzhe erkyn udyr-shamych tolych	потом потихоньку пришли девушки
kochkynam myj	я наелась
kak swadby ne bylo	как свадьбы не было
o kapka onchylno kapka onchylno shinchem da tushto enyzhwondo ulyt da enyzhwondo lyshtash kande lijyn shinche	у ворот у ворот сижу там малинник растёт и вдруг листья стали синими
a jymalnyzhe  	а под ним  
i galazhyn udyrzho unykazhe nylytyn mijenyt	и галина дочь внучка вчетвером гуляли
poka hodit mo mogla wse hodila molilas	пока ходить могла всё ходила молилась
a potom my platit ne hoteli mertwomu-to dak	а потом мы платить не хотели за мёртвого-то
tuge manesh yle	так говорил
ere zernatym	всё время зерно
tyshtyzhe osal ulo manyt yle	говорили что здесь обитает злой дух
no tudo da kertesh	но он да умеет
kok toja ulo	есть две палки
mm	мм
kum ij tunemym da wara	три года проучилась и потом
shinchamlanat ito predlagatlen ogytyl operatsij yshtash	и на глаза и то не предлагали делать операцию
oskansolashkyzhe	в оскансолу
eto wed uzhe tretij da dom manych postroili-to	это ведь уже третий дом да ты сказала они построили-то
nuryshto ynde myj anam shurem	на поле я землю бороню
tewe ko ojlysh	кто же говорил…
dawlenij 	давление
ik murymat muren otyl manesh	и ни одну песню не спела говорит
bezdetnyjym tulyman manesh	налог на бездетность надо платить говорит
wot	вот
pordalam yle manyn myj om shinche	что я валялась  я не знаю
uchastkyshte ilenna kok ij	на участке два года жили
ugu	угу
yndyzhe tynar omat kert	сейчас я болею
no awam silom marlan puysh wara	но мама насильно выдала замуж
susyrgen tolsho-shamych	которые вернулись с войны раненые…
chajet kulesh manam da	не надо говорит
kud shochshym yshtenna	шестерых детей родили
ushemnuryn kusotyzho uke	у ушемнурцев нет рощи
a chto-nibud smeshnoje na rabote bylo	а что-нибудь смешное на работе было
shylshym ashna gyn	если прячет дезертира
chto tolko ni delali	что только ни делали
watyzhe	жена
oloshyn port wutazhe chisti laptyrgen	у алексея дом хлев совсем осели
feldsherskij shkolyshket tunemash purenam	в фельдшерскую школу учиться поступила
tuzho imne wak shinchash ok lij	на жерёбую лошадь нельзя садиться
a-a	а-а
ulo jal kalyk	вся деревня
won segodna k babushke-to hodili oni tam zhili	вон сегодня к бабушке-то ходили они там жили
a eto oj ukraina stradal	а это ой украина страдала
net net ne widela ne widela	нет не видела не видела
tudo suan dene koshtmyzhym eshe kunam gyna charnen	она когда только перестала ходить на свадьбу
shinchyn ona kert	сесть не можем
mari-turek rajon kolten myjym wara oloryshko	в мари-турекский район направили меня в олоры
wot pukshat manych	вот кормили говоришь
memnan washtareshak dwuhetazhnyj do dom yle	напротив нас двухэтажный дом был
kyzyt gyn pujazhym pengydyn yshtyme	а сейчас пруд крепко сделан
kushajte	кушайте
kindym nalyn kochkash memnan prawa uke yle mongyshto	хлеб самим брать у нас не было прав дома
eshe malat yle juzhgunam tukalen purem yle echanmyt dek osobenno	ещё спали иногда я стучалась и заходила особенно к эчану
kakaja tam pechka	какая там печка
wot-wot	вот-вот
ikmynar zhap shinchymeke	после того как он посидел некоторое время
znachit tak wot	значит так вот
no kuchen koshtyn onal sowsem shuzhenzhe jodysht koshtyn onal me	но мы не ходили просить милостыню совсем голодные но не просили милостыню
ojyrlen	разошлась
a tushto wet torfym pesh luktyt yle wet pasushto	а там торф извлекали в поле
torykym juam	простоквашу пью
tushto wara porjen-shamych dotowo tumanlash tynalych	а там мужики начали очень сильно ругаться
net	нет
shorykym 	овцу 
kaja	уходит
mo shym ijash mom sharnet	семилетний что помнит
dawajte manyna	давайте мол
koshtyt	очень много ходило…
joren omyl	не подходила им
mozho jyranjet logalesh konshudan	это   участок попадался с лебедой
perwyj juash	сначала пить
k dade-to	к дяде-то
shinchalym pyshtenyt	соль клали
koremyshte kuryk sangashte ala-kushto	в овраге на горке где-то
agytan uremzhe	агытан урем…
ti pesh wucha aman ynde	эта-то ждёт меня видать
awazhe mita den witam	мама митю с витей
ugu tak a wy	угу так а вы
tushto pesh orlandarat manesh yle	там ведь потом будут мучить тебя говорила
ik muzhikym shkol woktene	одного мужика рядом со школой
kniga tetrad sityshyn lijyn mo	книг тетрадей достаточно было
su puskaj sudat tam horonat	пускай судят там хоронят
wara shkenan tunyktyshynam uzhyn kondyshna	потом свою учительницу позвали
jashtrekshe wet tora tyshechyn	яштрек-то далеко отсюда
wot tygaj anekdot	вот такой анекдот
ala-molan tyge puren ala-mo	почему-то так суждено наверное
ilash da ilash wele	жить да жить только
kalyket wet kolyn kertyt wso-taki	люди ведь могут услышать всё-таки
oloryshko mari-turekyshke mari-turek rajon	в олоры в мари-турек в мари-турекский район
myj wet mujym kyzyt wele chaj dene juam sowla neresh koshtalyn	я ведь мёд сейчас только с чаем пью зачерпнув кончиком ложки
tylanda ludmashan ogyl shkolyshto ilash	вам не страшно жить в школе
i wso om kaj ynde	и всё больше теперь не пойду
da	да
myj kok ij tunemash puren omyl	я два года не училась
nina sergejewnat lekte	вышла нина сергеевна
myj kochkyn omyl	я не ела
on prowodil	он проводил
wate-shamychlan pueden tushto da	выдавал женщинам
oj myj om sharne	ой я не помню
oj wet kok ij eshe orlanash kylesh	ой ведь два года мучаться надо
rush yle oza kuwanazhe	наша хозяйка была русская
mongeshet tolynam	обратно-то вернулась
tygaj situatsijzhe lijesh da pesh mozho ogyl	такая ситуация бывает ничего особенного
kandash kilometrym	восемь километров
ku kugyzat ynde uesh mom yshta	а дедушка опять это
ne wozrazhajete	не возражаете
udyryshtym	дочек
w tserkwu i	и церковь и
nu znachit portysh puren shukten otyl tyje tuno	ну значит ты в дом не успела зайти на улице…
wara patdesat chetwortyjyshto patdesat patyjyshte dekabryshte tolyn ulynna uzhe	потом в пятьдесят четвёртом пятьдесят пятом в декабре уже приехали
wot mur muryzh m	вот
polshash ok kul	не надо помочь
a kak eto nu w smysle eto w kakije-to spetsialnyje dni ili	а как это ну в смысле это в какие-то специальные дни или
uremyshke lektych	вышли на улицу
izi wet	маленькая ведь
wara myjyn imnym kuralash koltysht	потом мою лошадь пахать отправили
jesli chto	если что
izi jochatlan	маленькому ребёнку
hodila	ходила
molodozhat ulyt	вот парни бегают к нам
jochazhe tunamzhe	а дети тогда
myj shonem	я думаю
i izishak gyna lozhashym	и добавляешь немного муки
kunchyla shudyrash	прясть пряжу
umsham wel pesh koshken diabetetlan	только горло сохнет из-за диабета
muzh s dwadtsat sedmogo byl sem let sluzhil tozhe	муж двадцать седьмого был семь лет служил тоже
ushkalym nyngajysht da myj shortyn shogen kodym	коров перевели а я стояла и плакала
a tushkyzho onchash koshtynda mo	а вы туда ходили смотреть
wara peledysh tantsym	потом танец пеледыш
a memnazhe mom  	а мы это  
tide znachit tygaj  	значит такой  
izwinite	извините
shudo utla jen yle a kyzyte	когда я приехала более ста человек а сейчас
rweze-wlak kuchen shogalynyt	парни стоят держат
aga ot was-to tam	ага от вас-то там
wot tu suara kochkyn myjyn pagarem korshten yle olashte	вот те сухари когда я ела у меня желудок потом болел в городе
nu ti dene zhapshat erten kajysh	ну за этими приготовлениями время пролетело 
a horonit-to potom ne hodili wrode	а хоронить-то потом не ходили вроде
tuka-matuka	тюка-матюка
oj tyshte kashakyn wara juyna yle pogynen pajremym yshtena yle tunam wesela lijyn	ой здесь мы собирались компанией и пили устраивали праздники тогда весело было
nu kandash eshe mozhet latkokyt lijyn ogyl ikanat	ну восемь может быть но двенадцати не было никак
ubiwajut	убивают
kuzenat kochkam tum-tum wolenat kochkam tum-tum ruenat kochkam tum-tum	залезу съем тум-тум слезу съем тум-тум срублю съем
a ne znaj	а не знаю
wot juzhgunamzhe wara shonaltet wot	вот потом иногда и вспоминаешь 
imne den myj tu imne den nyl ij rabotajyshym	на лошади на той лошади я четыре года работала
ikte kongambachyn unchyliwujyn shogalten	один с печки спустил
ulno muchash mikojan kolhoz	нижний конец колхоз микояна
ynde mongo tolyn shuyt	уже дошли до дома
kumaltyshym yshtash	на моленье
ni razu ne delala ne znaju	ни разу не делала не знаю
w wara myj wursem	потом я ругаю
w shkolu	в школу
agroshkolyshket puren tudo ijynak	в агрошколу поступила в том же году
witle kum ijysh toshkalynam	пятьдесят третий год идёт
dawaj mo den kondena	на чём повезём
medpunkt derewannyj shukshu port tushtak mo   medpunkt kudwechyshtak mo	медпункт деревянный старый дом там же во дворе медпункта это…
chodyrashte  	в лесу  
oksala yshtash tunalynna yle	только начали работать за деньги
nu	ну
putinet wet adak mom yshta	путин-то опять это самое
nu tunalam wele	ну начну же
koktyn rabotajat	вдвоём работают
wara myjet kynelam eshe kuze malen koltenam ogyl	я встаю как ещё не уснула
i obschezhitij wdowol	и общежитие вдоволь
wojna godymet wet koshtash ok lij yle	ведь во время войны нельзя было ходить
kusotysh	в рощу
ushkalymat sosnamat onchena	и корову и свиней держим
a d dewanosto perwyj dech warazhe ynde wezde	а после девяносто первого уже теперь везде
toja dene	палками
kolkoz tynar obizhaja	колхоз столько обижает
shylanetym kojatym	мясное жирное
molan wot osobenno molodozh	почему вот особенно молодёжь
kumyzhysh opten shyndena er martek	в блюдо накладывали до утра
wolenat~	слезу~
wot w nowom torjale-to tserkow suschestwujet no	вот в новом торъяле-то церковь существует но
zra emym shuko uzhalena yle	всегда много лекарств продавали
udyrzho soglasijym ok pu	их дочь не даёт согласия
i tudak wara	и он же…
eshe mogaj yle	ещё что было
mynaryn ulyt yle	сколько было человек
yshten	родила
nylyt shagal	четыре мало
tudym	на газу
rabotajen	работал
o-o	о-о
desatyj nomer shurtym kondenyt manyt uniwermagyshke	десятый номер нитку привезли говорят в универмаг
a swokra-to che chetyre mesatsa tolko lezhal nu tolko nicho w rot to   s lozhkoj tolko kormila	а свёкра-то ложкой только кормила он только четыре месяца лежал
wara pesh shuko priwiwkym yshtash logalyn mylanem	потом мне пришлось делать очень много прививок
ma marla kalaskale	говори по-марийски
tunem lekte da tselinash kajash achazhe ok kolto	выучился да на целину отец не отпускает
miklaj	николай
eto   w starom torjale jejo deti a ona sama-to net	это   в старом торъяле её дети а она сама-то нет
tugaj istorij chaple ogyl myjyn	такая история некрасивая у меня
molochka-to nado na naljot ona	не-не мне как раз достаточно
uke	нет
murashlanzhe~	ведь чтоб петь~
net	нет
on w kotorom godu w tridtsat dewatom godu ona rodila	в котором году в тридцать девятом году она родила
surtna ulo	дом есть
to jest jemu shestdesat uzhe bylo kogda wy rodilis	то есть ему шестьдесят уже было когда вы родились
mosh cherkyshkat	это в церковь
beda cheret lijesh yle	очередь бывала…
a kunam wara tyj tidyzhym palen nalynda chto posobijym nalynda	а когда вы это узнали что получали пособие
aj ala-mo tushto uzhe mondenam	ай что там уже забыла
latkok jen	двенадцать человек
myjym kolten ogytyl achan den awa	меня не отпустили мать с отцом
pogynen da	когда собираешься вместе
wara lowa	потом лёва
latkumytyn ala-mo wel ulyna	нас вроде бы только тринадцать
a-a   pychkemyshaltashyzhat uzhe washke pychkemyshaltash tunalyn	а-а   уже стало рано темнеть
kok gana udyrem godym tyge pesh chot ludynam	два раза в девичестве очень сильно испугалась
i wot wich ij gychyn me	и вот через пять лет мы
trahsestra ulo a wso rawno feldsher dechyn jodyt yle trahomym	трахсестра была а всё равно с фельдшера требовали
kochkyn ugu	съела угу
kajena oshkylyna ynde	вот идём
ruenat kochkam tum-tum	срублю съем
ne poluchajetsa	не получается
jy jygyr azam yshtyshyla wurlen kolen	во время родов умерла от потери крови
nuno	они  
ikmynar zhap gychyn witanat enyrzhym kol shupshyle	через некоторое время и на витину удочку зацепилась рыба
tor staryj torjalyshke	в старый торъял
tygerakyn onajyn lektyn	вот так интересно получилось
indap	индап
i sejch sejchas tam ubjut	и сейчас там убивают
kochkash uke i wtoroj smenyshte tunemynna myj nyl ij wtoroj smenyshte	есть нечего было во вторую смену учились четыре года во вторую смену
kumytsho lijesh	три будет
eshe sajyn wolgaltynat ok shu myj kajem shkolyshko	ещё хорошо не рассветало я уже иду в школу
shuko urem yle kugu jal pesh	много улиц было большая деревня очень
a wara kush munyzhym chykat yle	а куда девали яйца
ala	может
sergej romanych manym	сергей романович говорю
wara	потом
tri s polowinoj goda bylo	три с половиной года было
o ojlat chto	говорят что
joshkar-olashke	в йошкар-олу…
nuno udat	они сеют
myj	я
julymo pochesh	после пожара
tum pesh shuko mo ashnenam yle	её очень долго… хранила
washlijmash	встреча
klassnam shkolnam u tunemme ijlan	класс школу на новый учебный год
kum ij wel tunemynam	три года только училась
kas wtoroj smenyshte dyk	вечер во вторую смену
a enyr muchashte	а на конце удочки
motalmash manmet yle	был моталмаш
washlijmash koneshno shinchawud dene	встреча конечно со слезами
tewe jelu koka	вот тётя елена
sajyn jenzhe den da jolemzhat oshkyl ok kert da	хорошо с людьми    и ноги не ходят
tide shkolyshto dux-shamych koshtyt targyltysh	ведь в этой школе ходят духи нечистая сила
w ambary wymeli da	амбары вымели
kakaja	какая
kajena	идём
uzhe u wseh byli	уже у всех были
i tuflyzhym myjyn muzhskoj tufletym ana chijen kajen	и туфли а мои мужские туфли анна надела
ny	ни
pun pyrche wolyk uke yle	скотины не было
nu	ну
kirzawod da strojkyshko da mojn kajen pytenut	на кирзавод на стройку и ещё куда-то уехали
m-m	м-м
pej manyt	пей говорят
nichego shochesh yle takshe	ничего была вообще-то
i mondet manme   ma semyn	и забудешь об этом
mo mogaj mozho saj sluchajzhe	что какой хороший случайто
prostojrak kolhoznikshe wara poslednij ochered	простые колхозники потом в последнюю очередь
pesh kuzhu zhap rabotajen yle dyk	очень долго работала
ynde kolam peshak	теперь слышу
mongyshto eshe	дома ещё
ajsta manyna lumyn nunylan uchym yshtena	давайте говорим им отомстим
sholyzho tide	это его братишка
a-a myjzhe umylenam ushemnur nergen ojlet	а-а я-то поняла что ты про ушемнур говоришь
tudym kocha chyla rukowoditel yle memnan hozajstwyshtyzhe	дедушка был руководителем у нас в хозяйстве
kak wot sejchas	как вот сейчас
kugyza uke ogesh koj	а дедушки нет не видно
luget	перемешаешь
kugu marij lijyn	стал взрослым
chyla jushtyshtet tu jolet tunyn ala-mo	в холоде отнялись ноги что ли
a mylam orwa ok kul	а мне не нужна телега
i shketyn koshtynam myj wosmoj klassyshke	и одна ходила я в восьмой класс
myj oksam uzhyn omyl om pale	я денег не видела не знала
wara kas kas shumeke izish mynar iktazh	потом к вечеру ко скольки часам примерно
ludi-to druzhilis	люди-то дружились
acham dechyn kolo ij izi yle	она была на двадцать лет моложе отца
kolodichym kunchenna moncham yshtenna mocha uke yle wet	колодец вырыли баню построили бани не было
ojlenzhat sajyn kertyn omyl	даже говорить как следует не могла
postrojka-to wot o otkuda u nas ne bylo ne stalo	постройки-то вот почему у нас не стало
warat kajenam myje	потом уехала я…
tunam wet tij pesh nalesh yle wurgemyshtat	тогда ведь вши водились и на одежде
tide ti ijyn   a   mo	в этом году это  
a-a   shinchatshe mogaj wara glaukoma manyt mo	а глаза как говорят что глаукома
kaslan mongo tolyn shuynam	к вечеру доехала до дома
a myjzhat myjzhat wet em dene wel shoram	я тоже я ведь тоже только с лекарством хожу
oncho tyshke wara marlan tolmeketshe	смотри когда вышла сюда замуж
tuge lij wara	это случилось потом
shestdesat sedmojysh marten	до шестьдесят седьмого
tudyn familijzhym pujalan puash	того имя дать пруду
kolynam no myj om moshto	слышала но я не умею
kolhoz dech ordyzhto kodyn onal me	мы не оставались в стороне от колхоза
ne wozrazhajesh manesh	не возражаешь мол
ot mu	не найдёшь
kunam kumaltyshym yshtat	когда проводят моленье
ne	нет
oj udyramash-wlak	ой женщины
kakoj-to takoj sidit i tuda zhe my hodili molilis	какой-то такой сидит и туда же мы ходили молились
pasu gochyn	через поле
wannym kondena zaodno selinam mushkashlan	ванну привезём чтобы селину заодно искупать
ozhno tyge yshtenyt	раньше так делали
wuta yle	коровник был
kolyshtykta	даcт послушать
lektynam myj marlan	я вышла замуж
i memnan klassshat tudyn eee  	и наш класс у неё
kongat uke gyn	если печки нет
e	э
ny emym nalyn ogytyl ala-mo	и лекарство что ли не покупали
latkokyt olmeshet nylytat lijesh	вместо двенадцати четыре будет
wot i bolshe nymam dobawitlymashysht da moda uke	и больше ничего не добавляют
imnem pesh chaple yle	лошадь-то очень хорошая была
no wso rawno myj	но всё равно я
kongambalnet wara myj kychkyralynam	на печке я крикнула
sadik tunam uke nigo onchysho uke	садика не было тогда некому водиться
erla memnan	и завтра наша
ili duhowkyshko lijesh	или можно и в духовку
a my konskij schawel ne jeli	а мы конский щавель не ели
eshe tak	ещё так
a zamuzh ona wyshla ne wyshla	а замуж она вышла не вышла
tu ijlan myjyn dekem kuznech gychyn	в тот год из кузнецов мне
jolashysh shorynam yle wet eshe	в штаны накакала ещё
studentam	студентам
uke uke uke	нет нет нет
kapka onchylno	перед воротами…
tumna tum-tum tumna tum-tum	сова тум-тум сова тум-тум
saj wrode by ok ju latik ij sluzhitlen dyk	хороший вроде бы не пьёт одиннадцать лет отслужил
kudlo ijyn tema wso-taki gde-to	шестьдесят лет всё-таки ей исполняется где-то
myj welosiped den koshtyn om moshto yle	я не умела ездить на велосипеде
kushtat ala-mo	то ли пляшут
jalna onchychyn kok kolhozlan shelaltyn	сначала наша деревня делилась на два колхоза
nyl ij paralizowatlaltyn dyk chyla e-e	четыре года лежал парализованный и э-э…
i kostimyt dek wara mijen puren ulyna	и к косте мы приехали
muro-wlakshymat tozhe tu toshto-wlakym lijesh	песни тоже старинные можно
tuge koshtynna	так вот и ходили
posna kydezh yle	отдельная комната была
kastene to e-e   tolynna da erdene	вечером э-э приехали и утром
wyboryshket kajet	на выборы пойдёшь
malen koltenam	уснула
no tunam   udyr-kachyzhat shuko lijynyt chaj	но тогда и молодёжи много было
pokazhu jejo drugim ludam	покажу её другим людям
ploka slabyj imnym puenut	плохую слабую лошадь дали
tynalym	и начала
onchychshat lijyn ogyl tygajzhe	и раньше не было такого
sokyr petyr den watyzh gaj wel koshtyda manesh	ходите как слепой пётр и его жена говорит
tumna shortesh-shortesh da ik igyzhym kudalta	сова плачет-плачет и одного совёнка бросает
ok wolo i wso	не снижается и всё
awam kolhoznitsa lijyn	мама колхозницей была
rabotajem kolhozyshto	работаю в колхозе
da wudyshke shuysht	и закинули в воду
wara tushto sosha uke yle ulo yle kermych gyna	там не было шоссе была кирпичная дорога
wich keche shogysh	пять дней она отдыхала
lektym	вышла
wot tyj kyzytat ojlyshych	вот и ты сейчас говорил
lozhashym	муку
tyj ojlenat yle	ты рассказывала
uke-uke ny nygo predlagatlen ogytyl	нет-нет никто не предлагал
miklaj holodilnikym mogaj godyshto nalynna perwyjym	николай холодильник в каком году покупали первый
myj nygush kajydeak kodym	я никуда не уехала осталась
stoletije jescho otmechali	столетие ещё отмечали
wot te tygaj anekdot	вот такой анекдот
chomam yshtysh	ожеребилась
wara ana imnet kolen ana imnet kolen manyt	потом анна лошадь умерла анна лошадь умерла говорят
nylytyn ulyt yle wizyt marijet myjyn wizymshe wizyt wele	четверо было их пятеро муж-то пятый пять только…
wara tyshke medpunktyshket tolynyt da	потом в медпункт приезжали 
umbalym shinchalym	сметану соль
a pidashyzhe	а вязать…
a kindylanzhe mogaj cheret yle	а за хлебом какая очередь была…
mom   ko kombym pokten woltem tunam wet kombym pesh orolyman yle kazhne portan kombym ashnat yle	это   за гусями шла тогда ведь гусей надо было сторожить в каждом доме держали гусей
tene ynde sheshke wel wuden koshtesh	нынче уже только сноха водит
ala-molan ogyt yshte	в токтайбеляке почему-то нет
aj tunamak chygan chodyra da mo da manyt tyshtet	ай ещё тогда прозвали цыганский лес
manynut	сказали
posobijym puenyt kolymongyzho	пособие дали после его смерти
uke it yshtykte manynut molodoj udyr-shamych ulyt yle olashte	нет не делай говорили молодые девчонки в городе
pomyzhaltam adakat opat tantse	просыпаюсь опять танец
kajem kombajnorlan tunemam da	пойду выучусь на комбайнёра и
tyjat ushemnur pawyl lijat	и ты будешь ушемнур павел
tudo uzhash puren	приходил звать
mo   nabirajetsa mo ucheniki mo li kuze	набираются ученики что ли…
tyjzhe kushto ulat	а ты-то где
myj mondyshym jora ynde marla kutyrem	я забыла ладно сейчас по-марийски буду говорить
da salmaginde memnan ere yle	да салмагинде у нас всегда было
dojarkylan yshtenam	дояркой работала
rudikmytyn	у рудика и его семьи
muro tewe muryktat	спой если просят
tide peledyshym nalat	этот цветок если возьмёшь
tuwyrem joshkar tashman yle i showyrem jash joshkar tashman	платье моё с красной тесьмой было и шовыр с красной тесьмой
mo natalja aleksejewnazhe uke ynde	ну что натальи алексеевны нет теперь
tudetym wara ere er-kas pozhalynna konuket den ere er-kas	потом это вдували с конюхом утром и вечером утром и вечером
kural kertyn omyl	не могла пахать
tyj tunalynat  	ты начала  
wara sibiryshkyzhe tudym ulana memnan shemjermuchash udyrak	потом в сибирь её улана из нашей деревни шемермучаш девушка
kindym pogen nalash polsha	помогает собирать хлеб
bashkir mogyryshto ila	в башкирии живёт
horosho	хорошо
tozhe a skolko zhe chelowek bylo detej	тоже а сколько же человек было детей
roditeli tozhe	родители тоже
tidyn nergen jocha-wlakna legendym pogat toshto jen-wlak kalaskalen kodenyt	об этом наши дети собирают легенды от старых людей
tak	так
rywyzh	лиса
pochinga jywrajsola gych wele tolyn da ere jywraj jywan	приехал из йыврайсолы и навсегда остался йыврай иван
a molo were chot cherkym yshtat	а в других местах строят церкви
jora tidyzhe neobazatelno	ладно это необязательно
puja ulo	есть пруд
no majam tunyktenam majam najukyn ok	но маю научил маю у наюк
shuran jolash den koshtynam	в засранных штанах и ходила
tide babushkin sad gala	бабушкин сад кажется
myjyn awamat tygajak	и моя мама так же
kandashyn rabotajena	ввосьмером работаем
saj matematik nichego ulam yle	хорошим математиком была ничего была
tudlanak wara awam silom marlan puysh pawyllan	поэтому мама и выдала насильно меня замуж за павла
wara myj	потом я
jashtrekyshke	в яштрек
i tyshechynzhe rodysh   rodo lijyn i tushechynzhe achan rodyzho lijyn wot palymetlan	и с этой стороны был родственником и с той стороны был роднёй отца вот а за знакомого
it shushkyn shinche	не жри
mom   pensijym kychalyn ogyl tudlan	это… пенсию не искали ей
shoshym	весной
kum wrach	три врача
kaja-kaja da zoja tol manesh	идёт-идёт и зоя иди кричит
i ala-mo tygaj shud	и что-то такой  
toroschin lew maksimowich	торощин лев максимович
pogynat	собираются
lenin dene ik ijash ulyna manesh yle	с лениным мы одного года говорил
kyzyt em uke medpunktyshto manyt	сейчас лекарств нет в медпункте говорят
shyzhym	осенью
onchen orat yle	диву даёшься
shinchazh den kuze dawno mo tozhe tolashet	с глазами-то… как… давно ли тоже мучаешься
jen dene da mo wele ilen koshtyn	и они жили у чужих
bolshe nimam ogesh kul	больше ничего не надо
lugenyt i er marte tudo shinchen	перемешивали и до утра оно стояло
da tude tudetym tolynyt awazh den koktyn	и приехали вдвоём с мамой
onchychynzho shke sokyr lijynam yle	сначала-то я ослепла
detaslyshte akam yshta yle	там работала моя сестра
wot shonena prawda	вот думаем правда
oloryshko mijenam zra chot kugu jal	в олоры приехала очень большая деревня
shochynam tuzhem indesh shudo kumlo wizymshe ijyshte	родилась в тысяча девятьсот тридцать пятом году
tu pesh joso zhap yle tozhe tunemme zhap	то очень трудное время было тоже время учёбы
kochsa kochsa	ешьте ешьте
chaj-to nado	чай-то надо
no perwyjzhe sajyn ilen ulyna	но сначала хорошо жили
wot uzhesh pura magazinyshke	вот зовёт входит в магазин
aj kuze ogyl	ай как нет…
kuze ilysh umbakyzhe shujnen	как жизнь продолжалась
eshe moetym ojlen onal-ys oncho kuze myj kochamet dene jomyn koshtynna	ещё об этом не рассказали смотри как мы с дедушкой потерялись
da turlym kalaskalysh	и разное рассказывала
uke	нет
myjzhe kuze wara malen kodynam	а я-то как уснула
tide kechyn yshtyme da tide weryshte	провели в этот день и на этом месте
shtoby tide moet sh ynzhe shalane manyn	чтобы это   не рассыпалось
ere uda	всегда сеет
latkud jen ulo	шестнадцать человек
puchymysh gajrak lijesh	получается вроде каши
i jol oshkyl ok kert	и ноги не ходят
rywyzh wujzhym saka da	лиса голову повесив
ruj mezhash shumesh kosht	до руя
rajon	район
a detskij sadshe jocham koshtykten ogytyl myjyn godym	а детский сад детей не водили при мне
tide lijyn	это было
tyjzhe sharnet	ты-то помнишь
koktyn ogyl dazhe kumytyn manash lijesh	не двое а даже трое можно сказать
u nas swo eto nowinka s togda sami tkali wed	у нас новинка тогда сами ткали ведь
pasham yshtenat medpunktyshto	работала в медпункте
tyge ojlenyt yle	так говорили
u tuwyr joshkar tashman	новое платье с красной лентой
aj terzhym kodenna mo jolyn tolynna gala	ай сани-то оставили пешком пришли
wara eshe shemjermuchashkat mijenna	потом ещё в шемермучаш ходили
wolenat kochkam tum-tum ruenat kochkam tum-tum	слезу съем тум-тум срублю съем
adak pogynena udyr-shamychet	мы девушки собираемся
tugezhe	точно
na nawerno udobrenij	наверное удобрение
tide shkolyshto myje latwich ij utla pasham yshtem	в этой школе я работаю более пятнадцати лет
kawashte ik pyl lapchykat uke	на небе ни облачка 
sorykan	сорыкан
ugu obazatelno	угу обязательно
mochashkyzhe puren shuktena kandash pele marte	успеем же помыться до восьми тридцати
wot kurt kurtno gaj chonan ulam	вот у меня железное сердце
pasushtetak dokan ulmem gaj chuchyn	мне показалось что нахожусь на поле
wara iktazh	потом наверное
paporotnik peledaltesh ijlan ik gana	папоротник цветёт один раз в году
yrykten	подогрела
a-a tudo ilen	а-а он жив остался
mo jo jochazhe ulo	что дети есть
jumo ogyl	не пила
kud shochshym yshtenna	шестерых родили
kush nyngajenut	куда увезли
mo tatarskij dewichij yle	татарский девичий был
mylam murym muren	мне песню поёт
wara tolyn da	вернулся
malenkim rebonkom	маленьким ребёнком
sho lewyrak-shokshyrak mestashke shyndet dyk	если поставишь в тёплое место
nawerno	наверное
a kyzyt olmyzho wele	а сейчас осталось только место
kuwa uke	бабушки нет
kum rweze-shamych	три парня
tyshtyzhe gyn	здесь-то
oj kuze manyt gala	ой как же называют
no tuge gynat tide  	но всё равно эти  
lida luman udyrzho yle	дочь лидия была
tendan acha kugyzatat myjym pesh obizhajen	твой свёкор тоже меня обижал
shonalte kyzytshe wot dyk	подумай сейчас
imnyzhym	лошадь-то
tudo chywe urem mo	это чыве урем что ли
dyk  	дык  
tudo ala-molan tunemyn pytaryshe kugu tunemshe yle	она на кого-то выучилась образованной была
da dwadtsat sedmoj majyshte wel tolynam	и двадцать седьмого мая только приехала
shkolyshko pesh er kajem manat yle	в школу очень рано уходила говорила ты
a kyzytshe myj gyn wes semyn yshtem	а сейчас я делаю по-другому
shinchazhe eshe uzhesh tygezhe uzhesh	глаза так-то ещё видят видят
shor den kongash ku kudaltyme parengym kochko da tuno koshtyn da myjzhe kongambak kuzyktyshym	картошку с молоком поел и поскольку он на улице гулял я его на печку подняла
a kak zamuzh w wyshli	а как замуж вышли
wara wes	потом другой
kuchymo parengymak mo ale koshtymym	сырую картошку или сушеную
kachym uzhyn da awa marlan puat	жениха увидев мама замуж выдаёт
mom  	что  
shujnalt wozyn	пролегла
erdene kud shagatlan tynalesh yle	в шесть часов утра начинало 
murym mura peshak	песню поёт
wot tu pochta wokten samyj korno goch gyna meduchilische	возле той почты через дорогу было медучилище
mogaj itog lijyn	какой был итог
serzhat tura	и круты берега
korma nyngajashet koltat	корма отправляют возить
togda zhe s chetyrnadtsati let mne loshad dali	тогда же с четырнадцати лет мне лошадь дали
nyl ij pyrla ilen ulyna me tudyn dene	четыре года вместе жили с ней
kum unykam ulo	у меня три внука
pesh begowoj	очень беговой
kupsola goch gala	через купсолу ли
mo saj ogyl tewe chto memnan te ti pajremlash werzhe memnan jal dech umbalne ogyl	что нехорошо это то что наш праздник проходил недалеко от деревни
tushko pyshtet shinchalym pesokym	туда положишь соль песок
kocha onchen	дедушка содержал нас…
horosho spasibo bolshoje	хорошо спасибо большое
nu wot znachit zhili wy wpaterom znachit roditeli i tri docheri ili jescho kto-nibud s wami wmeste zhil	ну вот значит жили вы впятером значит родители и три дочери или ещё кто-нибудь с вами вместе жил
wso  	всё  
kolkoz myjym pesh chot obizhajen	колхоз меня очень сильно обижал
wolten kertynam ogyl	не смогла спустить
weteran da eshe manyt mo	тем более ветеран
tidyn nergen kalykna tyge ojla	об этом наш народ так говорит
tudat memnan nergen sharnaltysh	она тоже о нам вспоминала
no tozhe izish sostojanijysht tygajrak yle	но тоже немного в таком состоянии
kotoryj goworit eto  	который говорит это  
swetikshe yle	света была
acham latkandash ij ertaltyshe lijyn	а отцу было восемнадцать лет
mo   pu port-shamych sa chastnyj domyshto ilenna	деревянные дома в частном доме жили
tide wojna zhapyshtak	это во время войны
shym port radamyshte wele ilena	жили в ряду из семи домов
kuralash koltysht	пахать отправили
kok gana ala-mo lij da	два раза что ли проводили
a tudo ala-kushko	а он куда-то
kochkam wot	ем вот
mom  	это  
wot jora manam eshe awam puen	ладно ещё говорю мама выдала
oj manyt tolyn wozyn da maj kychkyren kija aka myjym	ой приехала и лежит кричит говорит сестра
tu kwartiryshte chastnyj kwartiryshte	в той квартире частной квартире
tak kak po wremeni-to	как по времени-то
oj burany da moroz-to kakoj byl	ой бураны да мороз-то какой был
uzhat tyge korshten pagarem	видишь так оказывается болел желудок
ik suanysh	на одной свадьбе
nu wot	ну вот
porjen-wlak mom maleda	мужчины что вы спите
om pale kunar ganazhym no namijen sharnem myj	не знаю сколько раз но привозил помню я
dawlenijymak	давление
ruenat	срублю 
ja hodila   hodila	я ходила   ходила
aga	ага
gaj chuchesh	кажется
achazhe lesnik	отец лесник
togda jescho muzh zhil u mena	тогда ещё муж был жив у меня
tynar	столько
wara marj tyjym yshtenam	потом тебя родила
nuno kurzhyn koltysht	и они убежали
znachit e   	значит э   
tudo	в то
yle memnan uremyshte tygaj ikte izishak cherlyrak	была на нашей улице одна такая немножко больная
i pujam pujash pujalash kelshenyt	и договорились запрудить пруд
malen kolash ogyl yle mo tushto	нет чтобы и умереть там
oj akam myjym wursa yle tu pidmylan	ой моя старшая сестра меня ругала за то что я вязала
i byl w plenu	и был в плену
widite tut s kraju dyrka	видите тут с краю дырка
ukraina	украина
ushemnurzhyn tushto kok wuta yle	в ушемнуре там два коровника было
me  	мы
swatatsa	свататься
hot changa peshak osal yle no	хотя скупым очень злым был но…
shyp	тишина
koktyn ere lijynna	всегда вдвоём были
kumsho kechylan tumna deke maska tolesh	на третий день к сове приходит медведь
a mo den yshtenda	а из чего делали
sapondo  	цепами  
dada w gosti hodili my k nim	дядя в гости ходили мы к ним
a mongyshto nunym awazhe kuanen washlije	а дома их с радостью встретила мать
kolymsho ijun tolyn shuo	пришло двадцатое июня
akam dek mijen wara ik stakan sakyrlozhashym kondenam	к сестре сходила и принесла стакан песка
ere emym wot myje moshko tushko	всегда лекарство в это туда
tudat tygaj tora wer gychyn	и у него из такого далёкого места
pesh kochkyna	едим
wot tygerakyn ilena	так вот живём
otets jalsowetom byl	отец был главой сельсовета
portylna	вернулись
nikolajewnazhe wet pasham pesh sajyn yshta ko koltyza	ведь николаевна очень хорошо работает отпустите
akamet wara eshe	а сестра ещё…
parengym shyndenna poliwajen ona moshto	картошку сажали поливать не умели
myj imnem ikana tuchyn omyl	я на лошадь никогда руку не поднимала
no wso rawno choma kolysh	но всё равно жеребёнок подох
mo  	э-э  
sprosite teper	спросите теперь
myjzhe brigadirlan shotlaltam	я же бригадиром считаюсь
starshij wozchiklan koshtam eshe	я ещё за старшего возчика ездила
shoshym welesh	ближе к весне
myj kajenam wara olashket tewe	я уехала потом в город
wot shonena koneshnozhe	думаем конечно же
tunar kijenam	столько пролежала
kugyzam patidesatyj godash	мой муж 1950-ого года
tolko manesh yle kolash tunalyn da	только говорила когда начала умирать
oj kuze imnem juktalalshash	как же мне коня напоить
mongyshto tewe ushkal shur da mojn	дома коровий навоз и прочее
tide kunam owara	когда всё это поднимется
wozen tol maj chyla mogaj dokumentym kulesh tushko	запиши говорит всё какие документы нужны туда
imnetym petyren kodena	лошадь оставляем взаперти
jastaren kodyshym ynde	всё разгрузила
porjen jocha ulyt yle kumytyn	парней было трое
kolshash yle kumushka	хоть бы умереть хоть бы умереть кумушка
tetradshe tetrad lijyn mo	а тетради тетради были
nalynna me shkezhe	взяли мы с собой…
mo obazatelno	чего обязательно
shkolysh kajymashte agytan urem yle	по дороге в школу была агытан урем
kruchok denzhe pesh chot shuko pidynam myj o-oj	крючком я очень много вязала о-ой
a tide weryshke ko ilash tolyn	кто пришёл сюда первым жить
tewe tyshte yshtenyt dyk tyshkat	тут проводили  и сюда
kutyrash kutyren nalash kulesh toshto-wlakshe den	поговорить поговорить надо с бывшими 
shkezhe kolen koltysh	сама-то умерла
i kak u was kakoje hozajstwo bylo	и как у вас какое хозяйство было
kandash ij gych	через восемь лет
snoha doma	сноха дома
tu tushto	там
achazhe sokyr yle	отец слепой был
tushto jamdylash manyn chyla	там готовить всё 
na tebe uwezi	на тебе увези
kaja	уходит
tide wara pawyl den kajenda	это вы с павлом уехали
tache myj tylanda onchyktem kuze myjym uzhyn odal	сегодня я вам покажу как меня не видеть
gennadij maj myj mongo kajem maj	геннадий сказал я домой поеду сказал
erla ona kert	завтра не можем
no eto nado uzhe byt~	но это надо уже быть~
joneshtarena	получится
dewatyjyshket	в девятый
a chyla tide rush mutshym	а все эти русские слова
jora ajda izi pawyl gynat	ладно хоть павел и маленький 
juzhnam marij da mo da muralta tunam interesne yle wet kyzyt nyma interesyzhat uke ynde	иногда пели по-марийски тогда было интересно сейчас ничего интересного
oncho marij jalyshte shochynat-kushkynat tushto wet ere marla kutyrenyt	смотри ты в марийской деревне родилась и выросла там ведь всегда по-марийски разговаривали
a dwadtsatogo marta	а двадцатого марта
a deti gde zhiwut	а дети где живут
wara petyren shyndenyt	потом заперли
wara peshak kogartash tynalesh	потом начинается изжога
no wara tunam kijykten tylze	но тогда целый месяц пролежала
chernilazhym	а чернила сами делали сами приносили в школу…
kocham juktenyt chot	дедушку напоили
ere myj echanmyt dek purem yle ala-molan	всегда я к эчану заходила почему-то
galazhe tewe una ka sowetskijyshte yshta tozhe duhowkyshto	вот наша галя в советском тоже делает в духовке
berezin kugyzat sho shogen	и старик березин был
izi jeshna dene	нашей маленькой семьёй
chyla were rushla kutyrash tunalynyt marij elyshte	по-русски начали говорить в марий эл
wara yshtyshna	потом начали строиться
nu da	ну да
kuku jukymat kolyn omyl	но пение кукушки не слыхала
sami znajete	сами знаете
murym jodyt da	просят песню
kalyk pesh shuko yle jocha pesh shuko yle	народу очень много было детей много было
kak by kuze kalasash	как бы как сказать
da w warazhe	и потом
marla kutyrena kyzytshe	сейчас говорим по-марийски
da kajyshna diskotekysh	и пошли на дискотеку
wot	вот
zina shogal shogal myj ulam manam	зина стой стой это я говорю
shyshtanym joratat yle	в воске любили…
a na chom	а на чём
w gorod jescho otprawlali	в город ещё отправляли
sem	семь
tatarskij toshtetymak	татарский старый же
koshtyna yle imnela emlan imne dene ere	ездили на лошадях… за лекарствами всегда на лошадях
ik semyn wele kurshten moshta	пляшет-то однообразно
taja wara	тая потом
posle wojny-to wed tozhe ploho zhili 	после войны-то ведь тоже плохо жили 
indesh ij gychyn	через девять лет
tak pro ukrainu pogoworili	так про украину поговорили
u nas w derewne-to desat domow marijtsy byli wosem domow russkije byli	у нас в деревне-то десять домов марийцы были восемь домов русские были
urzha lozhash den myj joratem kindym	я люблю хлеб из ржи
enjer jogen erten	протекала река
tudo imnet den rabotajyshym	на этой лошади работала
pe patdesat wosmojyshtet wara ushkalym tyshechyn nangajysht kol kok  	в пятьдесят восьмом коров отсюда перевели два  
mosimyt dek koshtyna yle	в баню к моси ходили
myj ere wara shketyn bolshinstwo	я всё время одна была
shuzharzhe ulo yle	была сестра
rudikyn   mytyn ritamytyn~	у рудика у риты~
kuralash koltenut	направили пахать
m-m-m   uchashymash lekte shurgash tunalna	начался спор начали ругаться
a   rweze-shamych poka tushtak lijynyt	ребята пока оставались там же
shortash tunalam myj	я плакать начну
shuryshtyzho	в супе
onaj yle	было интересным
kychalym tuwyrtyshwudym	я искала сыворотку
wot sajzhym uzhyn onal i tyshte manme semyn myj uzhyn omyl i tushto	вот хорошего мы не видели и здесь я не видела и там
om kert shincham ok uzh	не могу глаза не видят
kalyk semyn chyla wolykym onchash tochena kuchena	так же как и народ стараемся смотреть за скотом держим скот
a tyshte pokla den	а здесь фёкла и
parengym wozitlena da	картошку возим и
a nemda enjer pesh motor	а река немда очень красивая
wso wmeste rabotali ja togda zhe nauchilas	всё вместе работали я тогда же научилась
shukyzh godym marij mut den washtaltash lijesh	часто можно заменить марийскими словами
toshto predse a o predsedatel yle	был старый председатель
nu starinnyj tushto purtena moshkak	ну старинный туда включим в это
e-e tyshtyzhe mom   latkudytsho ulyna mo	да здесь-то это   шестнадцать-то есть
suchkorubom rabotali	сучкорубами работали
kugyzamat traktoristak	муж тоже тракторист
wara kochametyn tupsho gyna kojesh kochan izishak jyzhwe-jazhwe	потом у дедушки только спина виднеется чуть-чуть
awam mongyshto ere chodyrashte	мама дома всё время в лесу
kelge lijyn	была глубокой
wy kogda w kako nu w smysle kakaja u was data rozhdenija	вы когда в каком  ну в смысле какая у вас дата рождения
wara myjzhe tujeshkenam ogyl wet	потом я ведь не заболела
mongyshto uke myj radiom  radio moshto ulo yle ee   kantoryshto	дома нет я радио… радио в этом было… в конторе
kazanysh shumesh shuyn	доехал до казани
awa silom puysh	но мама насильно выдала
muralte-jan	спой-ка
iktym	одну
shor shorym kochkam	молоко ем
w feldshersko-akusherskuju shkolu	в фельдшерско-акушерскую школу
m-m-m	м-м-м
mari-turek rajon ala-kushto	в мари-турекский район
myj matematikym urawnenijym sostawitlash om jorate yle	я математику уравнение составлять не любила
a kuze shonem myj bolnitsyshkyzhe logalynam molan pagaremzhe korshten tudymat om shinche	а как думаю в больницу я попала почему желудок-то заболел и этого не знаю
kostizhat wara juash tunalyn	и костя потом начал пить
lamgash sakena	на лямки вешаем
kum ij japonijyshte plenyshte ilen	три года жил в плену в японии
kuzen kochkash	залезть и сьесть
sakyrym podala pozhalash kulesh	сахар нужно вдувать в глаз жеребёнку
witle kum ijym uzhe temem	пятьдесят три года уже исполнится
prezym kolkoz gych puenut	телёнка-то колхоз дал
ala-molan ala-molan tygaj lijyn om pale	почему почему так случилось не знаю
awazhe nyl tuzhemlan nalyn	мама за четыре тысячи купила
myj k	я
adak u gychyn wich ij gychyn washlijash kutyren kelshyshna	снова через пять лет договорились встретиться
i wso	и всё
kodynam shym ijash da	осталась семилетняя да
kowa-kocha ulyna	мы бабушка с дедушкой
a shkolyshtyzho wet kindym puen ogytyl jara shurym pukshenyt	а в школе ведь хлеб не давали только супом кормили
a udyramash-wlak chylan jubkyshtym noltat peshak	женщины все поднимают юбки выше
awatshyn jolzho da mo lijesh wet	у мамы-то ноги ведь не болят
kusotysh kajash uke yle	в рощу нельзя было выходить
tide sharnymash koneshno	это воспоминание конечно
tushto medpunkt gaj yle semonowkyshtyzho	там медпункт был в семёновке
a   russkij wy kogda wyuchili	а   русский вы когда выучили
kuralash koltysht da	пахать отправили и
no awa memnan pesh   sajyn mushkesh yle	но мама моя очень хорошо стирала
shym gektar mlandyna ulo kolhozyshto	у нас семь гектаров земли в колхозе
uzhe erkyn kaja kalyket kajash tunalyn manyn	народ потихоньку стал расходиться
oksazhym myj om sharne	деньги я не помню
hodili	ходили
wot tygaj istorij myjyn	вот такая история у меня
nu normalno	ну нормально
uke ogym ogym myje ogym	нет нет-нет я нет
ala-molan kugyzazhe syren kolten kuwazhlan i judym	почему-то дедушка рассердился на бабушку и ночью
uzhalenam i tushto tuaram da mojn peremechym melnam uzhalen shogat yle	продала и там творожник да что да ватрушку блины продавали
chywe urem ogyl tudo	нет не чыве урем
chomam loktylat	жеребёнка испортишь
mo	это
tunam tuge ludynam	тогда так испугалась
a togda molitsa nelza bylo	а тогда молиться нельзя было
za wokzalom tushto	за вокзалом там
ala ludyn kychkyralynam	может испугалась и крикнула
nuno kosti watymyt	они семья кости вате
kugyzazhe kojdymo lijyn kolta	и вдруг дедушка стал невидимым
otets-to jezdil tuda chtoby domoj priwezti w bolnitsu-to ne dawal	отец-то ездил туда чтобы домой привезти в больницу-то не давал
uke wara tewe	нет вот потом
marina shochyn tushto	марина родилась там
myj mujym om jorate yle	я мёд не любила
soprano ili tam uzh so stseny pojot	сопрано или там уж со сцены поёт
ulo ulo tewe ulo	есть есть вот есть
a holodilnik	а холодильник
ik mogyrzho joshkarge wesyshtyzhe kande pesh chot karandash	с одной стороны красный с другой синий очень карандаш
kazhne diskotekyshte tushto	на каждой дискотеке там
jora	ладно
shochmyn kastene nalash mijen	в понедельник вечером приехал
lidan maksym den pyrlak kajenut	с максымом  мужем лиды вместе ушли
i brigadir obizhajen	и бригадир обижал
a schawela	а щавеля
no oskansolashkyzhe tolynam a tysh   ushemnurym myj uzhyn omyl dazhe	ну в оскансолу-то приезжала а сюда… ушемнур я даже не видела
kochatshe-kowatshe pensijym nalynyt mo	бабушка с дедушкой пенсию получали
luktynna	вывезли
nurenjeryshtyzhe	в нуренере
no awazhe kolen semdesat pat godyshto wara awazhe kolmenge achazhe pesh saj lije	да мать умерла в семьдесят пятом году потом после смерти матери отец-то очень хорошим стал
nele ogyl	нетрудно
erkyn-erkyn tunalash kulesh	потихоньку нужно начинать
tunam wet rezinke uke yle	тогда ведь не было резинки
mo warazhe kochamzhe kajen da myjzhe malen kodynam omyl gala	а потом дедушка ушёл а я осталась и уснула кажется
no kocha pesh osal yle	но дед очень вредным был
tide klat umbake kuzen shinchynam no	я на этот амбар забралась значит
kola shinchalan shudo	коля шинчалан шудо 
om sharne	не помню
kumytyn	втроём
pritop dene tyget washlijyt	притопами так встречаются
myj tridtsatyj godyshto shochynam dyk	я родилась в тридцатом году
acha-awa-wlak tunemshe tunyktysho	родители ученики учителя
mo godymet e-e	во время этого…
anisolashkat mijenam	и в анисолу ходила
terysym chyla luktyt yle pas pakchash pasushko	навоз весь вывозили на огород на поле
sheshke emym jodyn puysh da	сноха купила лекарство
tudo kolen uzhe dawno	она уже давно умерла
aj nuno pochesh juash tolynut wet	это ведь они приезжали вслед за свадьбой
mondenam myj tidyzhym	забыла я это
tolynna tyshke tyshke toktarysh tolynna perwyjak	приехали сюда в токтар приехали сначала
wara mo	ну и что
da wara mochashket kajem kok toja den	потом иду в баню с двумя палками
puja goch	через пруд
myjzhe tylat ojlenam	я тебе рассказывала
a otkuda zh on o was znal-to	а откуда ж он о вас знал-то
kugu pochto wokten yle meduchilischyzhe palet nawerno	возле большой почты было медучилище знаешь наверное
shoryn koltymeshkem ludynam	я до усрачки испугалась
pesh shukerte ozhno	очень давно
nu tozho nuzhda udyrym silom puenut	тоже как бедную девушку насильно её выдали
spetsialistom	специалистом
myj uzhe tunalam pidash	я уже начинаю вязать
ja jegorjewskim-to tri raza byla da	я в егорьевске-то три раза была
maksymzhe wet kugu yle memnanzhe izi yle	максым-то был постарше наш-то моложе был
wy ne wozrazhajete chto ja ispolzuju etu zapis	вы не возражаете что я использую эту запись
konechno	конечно
turlym sharnenna	разное вспоминали
marlan tolynam da	замуж вышла и
i pasuesh tudo jocha azam yshten memnan teresh	и в поле она родила на санях
chodyram ruen ulyna	лес рубили
nu-nu sjela da	и крапиву ела и лебеду ела
izorwam puysh	тележку дал
a myj udyramash-shamych	а мы женщины
i myjyn tolash logalyn tyshke staryj torjalyshke	и мне пришлось переехать сюда в старый торъял
wara kinoapparatetym torjalysh nyngajenam	потом киноаппарат в торъял увезла
goworili po-nashemu-to	говорили по-нашему-то
da eshe mogaj gyna shoga palet	да ещё как она пляшет знаешь
wot shochsho-shamychymat tygak tunyktenna	вот и детей так же научили
awgust tylzyshte kodsho ijyn	в августе месяце прошлого года
nuno kajat myjym ogyt kychkyre lumyn woshtylyn ogyt kychkyre	они уходят  меня не будят специально смеясь не будили
oj jorshyn om shinche	ой совсем не знаю
a-a pawyl mane kuwatym ala-gush cherkyshke kumalash kolten otyl	а-а павел ты жену куда-то в церковь молиться не отпустил
a tunam pesh tamle yle wet	а тогда ведь очень вкусная была
myjzhe eshe mochewoj puzyretym onchyktynem yle	я ещё хотела показать мочевой пузырь
kornyshtyzhak	по дороге
wara semdesat wtoroj godyshto memna	потом в семьдесят втором мы
tyge onchyktyshym da	на меня посмотрел и
tak nu jescho raz skazhite mne ne wozrazhajete li wy chto ja wso chto wy rasskazali pokazhu rasskazhu podelus s drugimi ludmi	так ну ещё раз скажите мне не возражаете ли вы что я всё что вы рассказали покажу расскажу поделюсь с другими людьми
memnan	у нас
wara wurgyzhym eshe mom yshtena yle	потом стебли ещё что делали
podelis podelis	поделись поделись
no wara shkolym pytarymeket olashke meduchilischyshke tunemashet purenat	но потом после школы в город в медучилище поступила
drozhzhi	дрожжи
oksam nalyn izishak sajyn yshtyshash myjym shysht kolto	нет чтобы получать деньги и хорошо поработать меня не отпустили
no puchymysh gajrak lijesh	да как каша
otets-to mat wse umerli a deti-to slawa bogu wse zhiwy	отец-то мать все умерли а дети-то слава богу все живы
koshtymymat eshe koshten ulyna da	и сушёную сушили да
nurenjeryshtat ulo	есть и в нуренере
pawyl dewatsot chet tretijyshte kolen dyk dewatsot chetwortyjyshtyzhe nalme ala-mo tide holodilnikshym shincha eshe tewe	павел в девятьсот четвёртом… третьем умер а в девятьсот четвёртом купили кажется этот холодильник вот ещё стоит
e-e   tushtat	а тут
kalyk-wlaklan sharnashysht	чтобы люди помнили
chisti wara kolymeshkysht tyge peshyzhak kelshen odal tyge kuze manash	до самой их смерти не очень-то дружили с ними
tyge tudo kalasen koden	и так сказала
uchashenyt kok predsedatel	поспорили два председателя
myj	я
nelesh ida nal	не обижайтесь
a te teper molitsa-to u nas sejchas nynche-to zdes stroili dak dwa raza byla a hodit ne mogu i glaza bl ploho gladat	а теперь молиться-то у нас сейчас нынче-то здесь строили два раза была а ходить не могу и глаза плохо видят
uzhe pishetsa da	уже пишется да
wot 	вот 
prodolzhaj	продолжай
tunemynnat pyrla ik mo   zhapyshte dyk	учились вместе в одно время
wara kudwechysh purysh da	потом зашла во двор
aj ulo uzhe yle	ай уже было
oj wyzow kunar yle	ой сколько вызовов было
wot tol tolynam dyk mo ushemnuryshto	вот потом приехала в ушемнуре
nine ynde wot  	эти вот теперь  
tyshke	сюда
memnan mashina tushto shoga yle da	у нас там стояла машина
wot emym ot koch ot ju gyn uke wso	лекарство не примешь и всё
nunozhe umylysht	они как-то поняли
wudshat kelge	и вода глубока
nurenjer gychyn torjalyshke	через нуренер в торъял
ik igetym kudalte-jan	одного совёнка брось
tudo memnan pyrla shinchash tunalyn	и он остался с нами
kowyshtam onchen kushtena kolhozlan polshena	выращиваем капусту колхозу помогаем
nu a potom-to wnu wnuchka byla	ну а потом-то внучка была
jushto shyzhat toldale	наступила холодная осень
tygajak	такое же
nylde	сорок
a   a potom-to uhazhiwat-to mne zhe prishlos	а   а потом-то ухаживать-то мне же пришлось
shurym jesli sholyshtyn ikta wutashtet koden kertat gyn wele	если только не припрячешь навоз где-нибудь в хлеву
kuchyza kid den kuchash lijesh	ловите руками можно ловить
en perwyjzhe arna shoryn omyl	в первый раз я неделю не ходила в туалет
dewanosto let goworit zhit budesh	девяносто лет говорит жить будешь
uke jalet pyten	нет деревня исчезла
wot godshym om sharne	вот год не помню
umyremzhat kuzhu	и век мой длинен
pykshe wet ik wedram pogysht wishnym ik pushengyshte kostimyt den tide	еле-еле одно ведро собрали… вишню… с одного дерева у кости это
jodmo shuesh yle	хотелось бы спросить
gde um gde umejet tam zarabotajet	где умеет там заработает
kalyk shukshu-shamych pesh murat da	другие-то старые много поют
ushemnurzho gyn	ушемнур
oksam	деньги
izish kalaskalen puet	может расскажешь немного
oj tudyn ko pala lumzhym	её кто знает её имя
zernam wozitlenam toktajbelakysh	возила зерно в токтайбеляк
skazhite mne chto wy ne wozrazhajete chto ja budu ispolzowat i pokazywat ludam etu zapis	скажите мне что вы не возражаете что я буду использовать и показывать людям эту запись
bolnitsa tulen chaj aj zabyla shkola	больница платила кажется ай забыла школа…
acham	папа
‎kudash manesh myjyn jydalemym	сними говорит мои лапти
kuze kalykshat pesh chot tujeshkenyt ala-mo tunam	как люди очень болели что ли тогда
ko shkenzhynym kuchen shogalynyt	кто своё что-нибудь держит
a-a	а-а
takije pirogi u nas	такие пироги у нас
warazhe wet myj moshto toktaryshtyzhe kunam ilenam myjzhe	потом-то я в этом в токтаре когда я жила
aj myjzhe suan dene no pochesh juashet tolynyt yle galazhe lariwon watyzhe	ай мы за невестой а вслед приезжали галя жена иллариона
zawsklad lijyn	завскладом был
ala-molan kolen om kert	никак не могу умереть
tygajat lijyn	и такое бывало
les rubili dak	лес рубили
i wergym pokshech shelyn	и разорвал почку
wot suaratym myj kastene wudysh chyken shyndem	вот сухари я в воду клала
kawyrlan sepanyn	у кавырлина сепана 
kowaj	бабушка
nu na wsakij sluchaj me ere tyge nalyna yle prostynym	на всякий случай мы всегда с собой брали простынь
akazhe shuzharzhe yle marjat	сестра сестрёнка марья была
ere tugak   mo den numalme sumka dene	всегда в этом носили в сумке
kushyl muchash kynashenjer kolhoz	верхний конец кынашенерский колхоз
a   e   mat znachit u nego chto ne perwaja zhena byla	а мать значит у него что не первая жена была
towaret uke ugu	топора нет угу
pyrdyzhyshke kyshke pursam	на стену кидай горох
wissarionat shogen ala-mo	кажется и виссарион был
shongylykat toldale	старость пришла
zra chot sharnem tudym	очень хорошо помню его
mo wara wurzymysh akamytym	потом я разве в уржум сестру
turlo onaj lijyn	было много интересного
a potom suda-to prishla zhe na loshadi 	а потом сюда-то пришла же на лошади
pesh er kyneltysh	разбудила очень рано
zra chot korno ploka	дорога очень плохая
uzhar lyshtashyzhe sharlale	зато распустились зелёные листья
turedashet iziak koshtyna yle awalan polshash	жать с малых лет ходили маме помогать
i wot tysh tolynam i ere tyshte wara	и вот приехала сюда и всё время здесь…
shortash tunalam manyn ludynam wele	а я боюсь что начну плакать
krapiwu	крапиву
aga	ага
dak i to  	дак и то  
nu to togda uzh pahat-to perestali kogda ja zamuzh wyshla dak	ну тогда уж пахать-то перестали когда я замуж вышла
kyzyt ukraina memnam ok shotlo man	сейчас украина нас не признаёт
eee   tam po kakim-to powodam spetsia	там по каким-то поводам специа
m-m-m	м-м-м
kok gana koltenut-ys	ведь два раза передавали
rahitlan tozhe peshak strogo yle wot	насчёт рахита очень строго было
i yle kunam uzhe tul dene	и заканчивали когда уже свет зажигали
manazhe ojlen ok kert mo	маня-то не может что ли рассказать
ny ruchka uke	ни ручки нет
ola gychyn pesh tolyn prowerajat yle	из города приезжали с проверкой
eshe wiktyr luman ergym yle myjyn	ещё у меня был сын по имени виктор
prezym kolkoz puen	колхоз мне дал телёнка
ne znajesh	не знаешь
knigazhe mo ala myj om sharne tidyzhym gyn wele	книг не знаю я не помню этого книги были наверно
mogaj apteke yle tudo memnan	какая аптека там была у нас
da wishkyde nawerno	да жидкой наверное
chyla nyngajyzhe da kajyzhe	пусть всё заберёт с собой и уйдёт
wet marijzhe nalash tolyn yle tyshke sharnet imne mashin dene	ведь муж её за мной приезжал сюда помнишь на лошади… машине
owi akamyn unykazhym onchen  nanka lijyn	у тёти ови в городе нянчилась с внуком нянькой была
na taju taja den	с таей
memnam shongo kocha onchen utlarakshym shongo kowa 	мы жили под присмотром в основном старого деда и старая бабушка была
i tut zhe umer	и тут же умер
mo tyjzhe mo lijyn 	что случилось
s sorok chetwortogo goda on w armii byl kak   nu   w patidesatom tolko	с сорок четвёртого года он в армии был как   ну   в пятидесятом только
mo	это
kolo ij	двадцать лет
w shestdesat perwom godu	в шестьдесят первом году
kok osh bantik den chonjeshtylesh shkol muchko	с двумя белыми бантиками летает по школе
pesh jazhon horosho pojosh wed	очень хорошо поёшь ведь
na lesozagotowkah	на лесозаготовках
wolgaltesh	светает
shem kindylan	за чёрным хлебом
nimom ot nal yle	ничего не покупала
sadyshk sadikyshket koshtyktenut	в садик водили
cherkyshkyzhe	в церковь
chetyre wnuka tolko u mena	четыре внука только у меня
ala joga uzh myjyn	может у меня уже течёт
wot kotelok den cherot dene shogen tu showynym nalyna yle	вот с котелком в очереди стоя то мыло брали…
wladimir nikolaich	владимир николаевич
tana tache kajena kupsolash mochash purash	таня поехали сегодня в купсолу в баню
wot memnan awamat ere tyge ojla	вот и наша мама всегда так же говорит
a tolmet godym wolyk uke yle	а когда приехала не было скотины
i tudo budkyzhym julatenyt	и эту будку подожгли
knagam kudaltet cho	бумагу бросишь и что
gala patdesat patyj wiktyr patdesat sedmoj	галя пятьдесят пятого виктор пятьдесят седьмого 
no shuko gana ogyl no lijyn	но не часто но бывало
tak i roditeli washi byli tozhe iz nurenera ili	так и родители ваши были тоже из нуренера
i swekrowka-to pat let banu taskali tolko na sebe	и свекровку-то пять лет в баню таскала только на себе
kuwam shelyn pua	бабку ударяет
tana tyjak ulat dokan	таня это ты наверное
russkij mochetym eshe kadrilym shyndash kulesh tozhe	русскую эту кадриль нужно поставить тоже
i nyl ijyshte myj ik pel ijym nalyn omyl	и за четыре года я полгода не получала …
wse pojehalo	все поехало
chyla tidetym uzhynyt pesh chot ludynyt i kurzhyt peshak	все это увидели очень сильно испугались и бегут
tridtsatyj	в тридцатом
w smysle kak eto kak poznakomilis	в смысле как это как познакомились
yryktyme ogyl chaj yryktash	не подогрели наверное подогреть
a pochemu	а почему
najelas ochen sytnyje bliny ochen wkusnyje	наелась очень сытные блины очень вкусные
kush purman	куда деться
awam ok pale tu posobijym ik ganat puen ogyl	мама не знает то пособие ни разу не отдавал
aga	ага
kupyshto chygan-shamych peshak ilat	на болоте цыгане живут
myj kochkyn onal yle	мы не ели
wetka	ветка…
tyshtak	здесь же
jydaletym kudashesh	лапти снимает
magazinyshtyzhe olashtyzhe	в магазине в городе
peshak awam wynerym kua yle	мама ткала холсты
i rush muzhik	и русский мужик
tudymat uzhynyt	её тоже видели
moshto patdesat dewatyjyshte yshtenna u   u portym	в этом… пятьдесят девятом построили новый дом
i kolen om kert	и умереть не могу
i  	и…
natala oncha yle pesh	наталья ухаживала за ними
tunemme ij muchko	в течение учебного года
kugurak ergymyn	у старшего сына…
   mogaj ijyshte	   в каком году
wara kushto lijesh kuznechyshkat mijenam	ещё куда можно и в кузнецы ходила
sapondo	цепы
maska jodesh	медведь спрашивает
wot tushto myj tuaram kochkynam ikana	вот там я творожник съела однажды
poprobowala chto li	попробовала что ли
hot	хоть
kombo den	с гусем
e-e kruchok dene	да крючком
wara polewaja ulitsa tushko	потом улица полевая
wot tenda tyshke ekspeditsij dene tolynda	вот вы сейчас сюда приехали с экспедицией
sorokowoj godyshto tunemynam	в сороковом году училась
motalmash yle	моталмаш был
kuze manyt tudym	как его называют
surtym pytarat manyn	его хозяйство уничтожат говорил отец
ojlen-ojlen	говорила говорила
tolynna wik korno dene	ехали по прямой дороге
wararak wararak wet tunalych	позже позже начали
podpisajlymashat uke	даже не подписываюсь
da koshtynam torjalysh i shket kajem yle ere	да ходила в торъял и одна ходила всегда
portonchylno mozhet byt ala-kushto	в сенях может быть или ещё где-нибудь
tudo wizymshe klassyshte tunemmyzh godym	она когда училась в пятом классе
komu chaj	кому чай
jora	ладно
a skolko zhe wash otets prozhil wsego	а сколько же ваш отец прожил всего
wot kochametyn~	вот дедушка-то~
awa pua bezdetnyjym tulash kulesh	мама замуж выдаёт бездетное надо платить
korno uke yle	дорог не было
no tendan ok shotlalt yle	но вашей не считалась
tumna tos	сова
kylmen kylmen koshtynam jydal dene	ходила замёрзла в лаптях была
chylan jubkyshtym noltalynyt da shogat	все юбки подняли и стоят
eto   eto   ronginskij rajon togda sejchas sowetskij rajon	это   это   ронгинский район тогда сейчас советский район
kunar wate nalash tolynyt tyshke shemjermuchashysh tolynyt nalash	сколько женщин приехало сюда в шемермучаш
leknezhe mo	выйти что ли хочет
tygaj jenym ona oncho manesh	а других нет говорит
parengym nawozym nangajenyt	картошку навоз увозили…
ugu	угу
eshe kredit den wele oksa uke yle	ещё только в кредит денег не было
gipnotizirowatlen tudo peshak	он очень сильно гипнотизировал
da ik muzhik	и один мужик
peshak kalyk shuko urem shuko	народу очень много улиц много
portysh purenam ogyl	в дом не заходила
nu wot tide wojna godso ilyshyzh gych eshe mom kalasen kertat mom sharnet	ну вот из той жизни в военные годы ещё что можешь сказать что помнишь
toktajbelakysh kajena	и едем в токтайбеляк
bolnitsysh tora porwyjzhe wet mari-turek rajon wara mari-turekyshk shym	до больницы далеко сначала мари-турекский район потом мари-турек…
tudo kolkozyn ok kul	и если колхозу не нужны 
oksa ere uke yle tudyn	денег всегда не было у него
wot tudo kozho	вот его кто
mom pirozhkizhe ulo mo	это пирожки-то есть
a myj pasushto shketyn opten tolam	а я в поле одна собираю и приношу
no myj	ну я
jocha   jochat eshe lijyn ogyl	детей тогда ещё не было
lomyzh wud den ala-kuze pesh oshemdat yle	водой с золой как-то отбеливали
tudlan tygaj lijynat maj	поэтому и ослеп
wy ne wozrazhajete jesli~	вы не возражаете если~
wolyk dene	со скотиной
takuju jeli	такую ели
no tewe wowkatyn	у вовки
fartukym chijen	фартук надела
pesh shukyn lijynyt	очень много было
kinde uke yle  	хлеба не было  
tyj sawyren pyshtet mo mozhym melnazhym	а ты переворачиваешь блины
tu shkol mekanizatsijysh tunemash puren myj shala pasha yshtenam	он поступил учиться в школу механизации я работала разнорабочей
tide ijun gajak ogyl	не то что июнь
warazhe mijenam da mo emym puat da u uke	потом ходила и это… лекарство дали
znachit operatsija	огурцы
mom kalaskalymanzhe wara	что рассказывать-то
peshak keche mo jandar kawa	очень ясное… небо
tygaj puren kajymat ogyl nimoat	не падала ничего
ne a w detstwe wot w tridtsatyje gody	не а в детстве вот в тридцатые годы
kuze me kyzyt washtaltynna	как мы теперь изменились
washport	вашпӧрт
nu suan eshe mogaj	ну свадьба а ещё какой
oshkylyt oshkylyt	идут идут
a kelshyme rwe-shamychemzhe watyshtym ere	а те парни своих жён
no parengyzhe	но картошка-то  
oj kuze	ой как же
tumna t	сова т~
wese watyzhym ere	другой жену постоянно
chyla were wet rushla kutyrat	везде по-русски же разговаривают
e-e shym kwartiran yle memnan	да семиквартирный был у нас
ko tushko namijen chyken myj om pale	кто туда засунул я не знаю
oj chot trahomym lechitlash logalyn	ой трахому приходилось сильно лечить
memnalan ynde kolo ij ertysh	прошло уже двадцать лет
sandene tide kumlymsho ijunyshto me iktyshke toshto shkol pele wokteke pogynen kutyrash kelshyshna	поэтому мы этого тридцатого июня вместе договорились встретиться около старой школы
   tudo wojnashte kolen dyk posobijym nalynda mo	   он на войне погиб если пособие получали
nu olashtyzhe	ну в городе
ikta-mom juyn kolem ala-mo manam da	может что-нибудь выпить да умереть говорила я
ilenna chastnyj kwartiryshte	жили на частной квартире
kak eto woobsche organizowano	как это вообще организовано
shke shke shke	сами сами сами
myjyn tanashemzhe lezu den marja ulyt echu den aka	моего возраста лезу и марья были эчу и сестра одного возраста
nylytyn	вчетвером
ik rweze memnan	один парень у нас
no jesharet eshe osh lozhashym	но нужно добавить ещё немного белой муки
wsego-to on dewat let sluzhil	всего-то он девять лет служил
ru tunemashyzhe ere wet rush mo marlazhe uke yle	учиться-то всегда на русском на марийском не было
nu wojna zhap wojna	ну военное время война
lubo turlo were ok lij yle kajash	в любую нельзя было ходить
a tyshkyzhe om pale umbakyzhe mo yle a noskim shinchem	а дальше не помню что было… а носки помню
nu i mogaj	ну и у кого
imne dech onchychyn	впереди лошади
tyj ojlenat yle	ты рассказывала…
a ja s russkim dewchonkam wso	а я с русскими девчонками всё 
i tudo shinchen	и это вымачивали
kazanyshte tif den boletlen da kolen	в казани заболел тифом и умер
jadykplak moshtyzho uke	а в ядыкбеляке нет
kuze ushemnurzho lijyn kuze  	как образовался ушемнур
mo gynat tunamak myjym tynesh purtenut	ну в общем меня тогда же окрестили
wot ushemnurym gyn shagal shinchem myj	про ушемнур я мало знаю
warazhe	позже
aga net net	ага нет нет
i mylanem kalasen ogytyl	а мне не сказали
jolyn ot kaj wet	пешком же не пойдёшь
chyla saj no	было все хорошо но
myj om sharne tetradym	я не помню тетради
m-m ti wara chisti mom ysh  	это   потом   до самой  
en onchych kyrenyt	сначала избили
ynde chylan udyramash-shamych	теперь все женщины
my w wojennoje wrema-to	мы в военное время-то
lu ijym ilenam dyk mo	десять лет прожила
kom   zhenam	этого… женю
molyzho ala-kush ala kajen pytenut ala kolen pytenut uke	остальные или куда-то разъехались или умерли
wara mom eshe	потом что ещё
chyla	все
wnuchki-to jest shestnadtsat shtuk ili cho li bolshe nikto	внучки-то есть шестнадцать штук или сколько больше никто
woshtylmash den shyrgyzhmash den erten	со смехом с улыбкой прошла
kychalat dezhurnyjym	ищешь дежурного
tugaj-shamychyn tij nalesh yle wara	у таких вши заводились потом
shemet ulam	смугленькая
perwyjzhe tewe ikymshylanzhe	сперва
myjym kum rweze joraten yle nalash marlan nalash ere planirowatlenyt	в меня трое парней влюбилось жениться планировали
weterinaryshte nymogaj em uke	у ветеринара нет никаких лекарств
no warazhe lariwan den ilymyzh godym	но потом когда она жила с илларионом
me manam operatsija mo o	что за такая операция о
kok ergym ulo	у меня есть два сына
ushkal wutam nyngajysht	коровник перевезли
wy rody prinimali zhe	вы роды принимали же
myj   myjzhe warazhym koshtyn omyl	я-то потом не ходила
rush yle no fodorowak yle fodorow dimitrij fodorowich yle	был русский но тоже фёдоров фёдоров дмитрий фёдорович
mom ruden koshtat manesh	чего ты ходишь-бубнишь говорит
jushto wudyshko mo chykena	в холодную воду засовывали
slawa bogu u nih desat ih rodila ona lida-to wse zhiwyje poka jescho	слава богу у них десять их родила она лидия-то все живые пока ещё
marij melodij denak	под марийскую же мелодию
poprobowat nado	попробовать надо
tak i kak kak korowy owtsy kozy kury utki	так и как как коровы овцы козы куры утки
tolyt gyn	когда приезжают
nu wot w washe wrema	ну вот в ваше время
kutan tugaje	ягодицы такие
shukshu portyshtyzho rywyzh ilat manesh	в старом доме лисы живут говорят
no kindym sheleden pua yle	хлеб делил и раздавал нам
wot myjyn shinchamzhat plonko wosht uzhmo gaj wel uzhesh	мои глаза-то как сквозь плёнку видят
pawyl	павел
tak	так
kowaj it yshtykte yshtyktet gyn ala sokyr lijat ala mo	бабушка не делай операцию если сделаешь можешь ослепнуть
a gy~	а~
telewizor kogda kupili telewizor	телевизор когда купили телевизор
tushto soldat-shamych peshak ulyt shukyn	там солдатов много было
kwartir yle	квартира была
u jego   eto	у него   это
oni luchshe zhili	они лучше жили
tush shuynam da wet imne kak toresh torshten da	до того места доехала лошадь как прыгнула и
muralte-muralte	спой спой
tojashet da mo da myj mijen omyl wara	хоронить я не ходила
tide erdene	в это утро
pochingalanat kajash tochyshna	попытались уехать на выселки
kadrilym joso ogyl tudym lijesh	кадриль нетрудно её можно
wolyklan pukshash uke yle parenge uke nuzhenna yle	скотину кормить не было картошки
wesym koltenut tu imne den	другого отправили на той лошади
kush kutyren kelshyshna	договорились
rweze-shamych memnan washtaresh tolyt	навстречу нам идут ребята
wuta omsazhe tyge izish wele ulo tushto rywyzh ila manesh	дверь в сарай только осталась там лиса живёт говорят
kak chut port lawyran dyk	как чуть в доме было грязно
tewe jadykplakyshte tewe kuer shoga 	вот около ядыкбеляка стоит березняк
it it uchashe	не спорь
lariwon wate pesh kertesh	жена иллариона может
toktaryshtyzhe	или в токтаре
znachit wy u was tri klassa tolko zakonchili	значит вы у вас три класса только закончили
da shestdesat sedmojyshto julenna chyla	а в шестьдесят седьмом сгорели
wot etu sobirali sushili	вот эту собирали сушили
tushto tek izishak kolyshtyt	там пусть послушают
marja mushkyran kodyn	мария беременна осталась
erden erak wedasi wudwaram nalyn enjer deke pamash deke wudlan wola ulmazhyn	рано утром федосья брала коромысло и спускалась к реке к роднику за водой
ynde kuwa ludyn pyten	теперь бабка очень испугалась
na dwa goda lesouchastoke zhili w 	на два года на лесоучастке жили в 
jalzh jal korgyshtak mom yshtenna dyk	внутри деревни что делаем
a pelenetshe shkolyshkyzho koshtyktenat mo	а с собой в школу что-нибудь носила
kochkashat pesh joso yle	питаться тоже было тяжело
medpunkt nergen pasha nergen mom kalasen kertat	про медпункт про свою работу что можешь рассказать
tunemynam myj pesh sajyn	училась я очень хорошо
poget gynat ozhnyset gaj ogyl	еcли соберёшь не такая как раньше
ala-molan ala-kuze	почему-то как-то
pokro dech wara kumaltyshym yshtat	после покрова проводят моленье
a myj	а я
oj ukraina pesh stradal	ой украина очень страдала
tudyn dene wara mylam urgen puenyt onchylshowychym	из него потом мне сшили передник
letom eto bylo	летом это было
no tygezhe wet uzhat	но так-то видишь
tudak shogalesh mo	он же будет
olashte znachit tunemynat kutyrashyzhe tyge lektesh	в городе значит научилась разговаривать так получается
putin shogalmet mongo wele	после путина только
shuwyret denak	со свирелью
tide rweze-shamychym tache ludyktena	этих ребят мы сегодня попугаем
mo	и это  
wot pidash turlash	вот вязать вышивать…
tushto uzhe	уже там
no	ну
a-a awazhe tugaj yle pesh lumo jymal tij gaj	мать-то такая была словно вошь под болячкой
latwizymshe awgustyshto	15 августа
tyshte tewe lo kon olmyshto   e  	вот здесь на месте лё   этого…
tudo wet kushko marlanzhe kajen gala	она куда замуж-то вышла
kochkych juych	поели попили
zhiwut won w kwartirah	живут вон в квартирах
nikitinzhe	никитин
imnetym   eshe myj ik pro iktym propustil	лошадь… ещё я одно пропустила
sorok chetwortyjyshto kajen	в сорок четвёртом ушёл
wernulsa	вернулся
parangazhe wara eshe tora	параньга-то ещё дальше
myjyn ulo mogyresh koksha nale	всё моё тело покрылось фурункулами
brigadir mo	бригадиром что ли
jalzhe wet pesh kugu kunar urem	деревня ведь очень большая сколько улиц
indesh ij armijyshte koshtyn	служил девять лет
uke	нет
myj   myj kuznechysh koshtynam	я в кузнецы ходила
talgydym konden puenyt yle talgydem pesh chaple yle	лошадь-двухлетку привели лошадь была такая прекрасная
jolzho lijesh koshtyn kertesh da tudyn wujushyzho peshak chot kaja	ноги не болят может ходить но у неё сильно кружится голова
kuchymymat nyngajat yle kuguzhym pesh chaplyzhym	и сырую увозили крупную хорошую
najuk den pyrla	с наюк вместе
i tudo zra chot wara kylmen tujeshken	и он cильно простудился и заболел
kogda on otets umer w sorok patom godu dwadtsat tretjego fewrala	когда отец умер   в сорок пятом году двадцать третьего февраля
potom otets syn-to w urzhum	потом отец сын-то в уржум
jydalym kudashash	лапти снять
enyzh lijyn yle no enyzhym ogyl myj shoptyrym uzhalash koshtynam	малина была но не малину я смородину ходила продавать
myj showyrym chijen kajenam shkolyshko	я шовыр надела в школу
chto tam	что там
awa woobsche oksam kuchen ogyl uzhyn ogyl	мама вообще деньги не держала не видела
mynar menge kilometr shemjermuchashyshkyzhe	туда-то сколько километров в шемермучаш-то
mochewoj puzyretym ojlenam	про мочевой пузырь сказала
lijynzhat ogyl	не было
lyko-to sobirat jescho hodish da	лыко-то собирать ещё ходишь
tyge ilen tolashena	так стараемся жить
wot tushko wet oncho salmashke ruashym pyshtet	вот туда ведь смотри тесто ложишь в сковородку
wo pesh wet interesno	очень ведь интересно
a nunyn uslowij saj yle	а у них условия были хорошие
posna onchenyt mo nuno	они отдельно держали
a teper hodit ne mogu	а теперь ходить не могу
mijen tolash lijesh	можно сходить
bednaja	бедная
tselinashke kajem	поеду на целину
staryj torjalyshte	в старом торъяле
kok gana tyge imnemlan shortym wara	два раза плакала из-за лошади а
wara er marte imnet shogen	до утра лошадь простояла там
kandashplak jal muchashte tugaj	на конце деревни кандашбеляк такое
tudyn marten shuktena shonet	думаешь до того успеем
tudo imne denak yshtenam	на этой же лошади работала
memnan den mocham ogyt olto dyk	у нас-то ведь баню не топят
ik igetym kudalte-jan	одного совёнка брось
ilen ulmash tumna	жила-была сова
i jela pila nawernoje i	и ела пила наверное
kindym pyshtash wot kinde tozhe	вот печь хлеб хлеб тоже
tserku-to wso narushili	церкви-то все разрушили
kindylan magazinyshtyzhe	за хлебом в магазине
erkyn dene chylazhat washtaltesh	потихоньку все меняется
kindym kuze pyshtash kindym	а хлеб как печь хлеб
rossijlan werchynak tunamzhe kyrenut	из-за россии же
konga washtaresh	в печи
chomatym e-e   imne chomam yshten	жеребёнка… лошадь ожеребилась
a myjzhyn kunam chungash tunalesh	а у меня когда начнёт клевать
rastratyzhym mylam tulash logalyn	долги пришлось мне платить
ere suan den koshtmyzhym da mo da wel ojla	она только про свадьбу и рассказывала
moshket tyshk matwejew tak shortam da jodyn ogyl	это туда… плакала и матвеев не стал просить 
mynar muyna	сколько найдём
shukyn uzhynyt	многие видели
m-m-m eto zhe ochen dolgaja istorija	м-м-м это же очень долгая история
wse eti pirozhki	все эти пирожки
na paru od ik shutochnyj ulo	на пару один шуточный есть
chylan kurzhynyt ynde	все побежали
meat ajdeme-wlak shongemyna	и мы люди стареем
shoshym ochistke yshtash kajenna da	весной ездили на очистку
m imne den tolyn	приехал на коне
sakyr uke nygushto	нигде нет сахара
eshe	ещё
tushto wara pesh chot juash tunalyn rastratym yshten lektyn	там сильно начал пить пустился в растраты и ушёл
tidyn dech onchych pogynenna wot	перед этим собрались вот
ynde wyboret wet washke shuesh	скоро ведь выборы
rush wa rush wate nale	русская женщина купила
i za interesnyje rasskazy	и за интересные рассказы
uzishket rentgenyshket kuze koltenyt	как направили на узи на рентген
eshe chot syren kaja manme da	ещё сильнее разозлится
etot	этот
tyge oksam kocha yshten millioner	так дед делал деньги… миллионер…
udash kulesh	надо сеять
w sorok patom on umer	в сорок пятом он умер
shuko jenyn tijym muyt yle	у многих вшей находили
mogaj godyshto yle	в каком году было
ogyl ogyl ogyl ogyl ogyl	нет нет нет нет нет
kak tudo lektyn kaja	как только она уходит
kajyza mana chyla shincha	сходите маня всё знает
ugu	угу
i tidym melna wake pyshtenyt	и её клали на блины
kondenna wara imne dene	мы привезли её потом на лошади
nuno pisyn gyna kynelyn	они быстро встали
tugerakak primerno	так же примерно
wot chewerlasat udyr-kache	вот прощаются жених и невеста
a terzhe kuze tushko tolyn	а сани как там появились
tatarskij to toshtymak toshtetymak	татарский старый старый
kom mom	кого что
